,Number-1,Number-2,Number-3,Number-4,Number-5,Number-6,Number-7,Sum
0,6,12,15,16,19,27,29,124
447,8,9,10,20,24,29,35,135
662,1,7,11,20,26,31,34,130
699,9,14,17,18,22,27,28,135
754,3,4,16,20,26,29,33,131
906,1,5,7,20,21,25,32,111
914,1,9,15,24,25,28,32,134
1102,4,9,15,18,19,31,35,131
1177,1,5,7,20,25,28,30,116
1240,4,8,14,24,27,29,35,141
1249,3,4,8,14,27,28,35,119
1521,4,9,15,18,26,30,31,133
1559,7,8,17,20,23,24,27,126
1974,1,4,14,20,21,27,31,118
2510,3,6,9,13,17,24,30,102
2575,7,14,15,17,21,24,31,129
2642,9,10,14,20,21,25,27,126
3023,2,9,10,19,23,25,29,117
3047,4,10,16,19,27,30,31,137
3383,1,7,15,20,25,30,34,132
3408,9,12,17,18,24,28,29,137
3475,5,7,10,18,19,25,29,113
3760,2,7,8,12,22,23,29,103
3837,4,8,9,11,25,27,31,115
3850,1,7,8,18,22,28,29,113
4117,8,9,11,20,24,26,31,129
4901,3,4,8,16,21,27,31,110
5267,3,6,11,18,21,24,25,108
5492,3,4,15,19,24,25,30,120
6037,6,9,17,18,21,24,27,122
6116,1,9,16,20,26,29,30,131
6143,7,14,17,18,24,26,29,135
6491,3,14,18,20,23,26,27,131
6643,3,7,9,13,19,24,32,107
6815,4,7,10,17,22,31,35,126
6980,1,3,7,18,29,32,34,124
7104,7,9,18,20,21,24,32,131
7246,3,6,17,18,21,27,33,125
7438,8,9,15,20,23,27,28,130
7487,2,5,11,20,21,23,25,107
7664,1,3,9,12,25,29,32,111
7746,8,9,16,20,21,27,32,133
7751,9,14,15,19,24,25,27,133
8017,7,8,11,20,23,26,29,124
8308,7,10,15,16,19,24,25,116
8800,2,7,8,12,17,24,33,103
9017,8,14,16,18,23,29,31,139
9233,4,9,15,20,24,26,29,127
9300,1,8,16,20,23,24,29,121
9348,1,6,7,20,23,27,32,116
9358,1,8,16,20,26,27,35,133
9405,1,9,16,20,26,27,35,134
9607,7,8,9,14,22,26,31,117
9737,2,4,9,13,19,24,35,106
9820,4,7,10,12,19,23,27,102
9835,5,7,17,18,23,27,28,125
9847,4,5,9,19,25,27,32,121
9948,7,8,9,14,22,29,33,122
10009,5,7,11,14,22,28,34,121
10686,8,9,15,16,24,29,33,134
10735,5,6,16,17,22,23,27,116
10798,7,12,14,19,27,29,33,141
10922,7,10,18,19,23,24,27,128
10953,7,12,14,20,23,25,29,130
10991,7,9,11,20,26,28,31,132
11017,8,9,11,13,17,27,28,113
11260,1,5,16,17,22,30,32,123
11271,7,14,17,18,22,24,35,137
11525,1,5,7,20,22,29,33,117
12344,1,3,9,18,22,28,35,116
12368,5,6,11,20,26,27,30,125
12583,8,9,14,18,21,24,35,129
12592,1,9,18,20,24,31,35,138
12670,5,9,14,24,25,31,33,141
12766,6,7,15,19,24,27,33,131
12881,8,9,10,12,27,29,35,130
13210,1,10,11,16,27,30,34,129
13290,9,10,14,18,24,25,35,135
13374,1,9,14,18,24,25,34,125
13544,9,10,16,17,21,31,32,136
13666,4,5,9,18,24,26,31,117
13811,5,7,9,18,24,26,28,117
13813,3,4,9,16,19,24,28,103
13819,1,3,9,20,22,24,27,106
13830,3,5,9,14,23,24,25,103
13950,9,14,18,19,24,31,33,148
14197,8,12,16,18,19,25,29,127
14273,7,9,14,20,24,30,33,137
14383,1,14,16,20,23,27,33,134
14384,9,12,17,18,24,27,31,138
14498,1,7,17,20,24,25,35,129
14509,1,9,16,24,29,31,35,145
14681,1,4,15,17,21,28,35,121
14726,3,7,10,24,26,27,30,127
14807,1,5,7,13,22,26,32,106
15513,3,14,16,19,22,23,31,128
16223,7,14,16,18,22,31,35,143
16299,4,12,15,19,22,25,29,126
16382,7,12,17,18,22,27,30,133
16524,2,7,11,14,22,27,33,116
16592,7,14,18,20,22,25,27,133
16665,4,10,18,19,25,29,33,138
16751,1,7,11,12,19,27,34,111
16765,2,4,8,19,24,25,31,113
16816,1,9,11,16,24,26,30,117
16882,4,8,15,18,19,23,29,116
16916,5,7,18,20,25,26,30,131
17181,8,14,15,16,19,26,29,127
17260,2,5,9,11,21,26,35,109
18028,1,3,7,11,22,29,30,103
18060,2,5,9,20,21,27,32,116
18115,7,8,14,18,24,29,33,133
18152,2,3,14,16,25,29,35,124
18180,7,10,17,18,21,24,31,128
18466,5,7,8,11,17,27,34,109
18563,1,3,7,20,22,27,31,111
18582,1,7,9,19,22,28,32,118
18584,2,4,11,17,23,25,27,109
18627,3,4,8,20,23,29,35,122
18875,6,7,10,13,26,27,29,118
18937,1,12,15,16,22,28,29,123
18973,3,9,11,13,22,26,31,115
19222,6,7,9,11,17,28,30,108
19588,7,8,10,20,21,23,27,116
19835,9,14,17,18,24,25,27,134
20052,3,7,14,20,23,27,28,122
20302,2,7,8,14,29,31,35,126
20367,6,7,8,11,22,29,35,118
20526,2,7,11,14,21,27,29,111
20656,3,7,8,18,22,23,28,109
20686,2,3,15,16,19,29,35,119
20833,5,9,16,20,25,26,27,128
20856,5,6,10,16,17,25,27,106
20908,2,7,16,19,23,27,29,123
20962,2,7,10,14,17,25,31,106
20972,8,9,10,13,21,24,30,115
21196,2,7,8,11,17,32,33,110
21304,5,7,11,18,19,25,28,113
21317,1,7,14,18,22,29,31,122
21321,4,8,11,16,27,30,33,129
21565,7,9,10,19,23,26,29,123
21681,7,8,11,18,23,24,27,118
22131,4,14,17,18,23,28,31,135
22264,1,5,15,16,22,25,31,115
22656,2,8,14,16,21,25,29,115
22942,2,7,8,11,22,23,35,108
22986,9,10,16,17,24,31,35,142
23121,2,12,16,19,25,29,32,135
23135,3,7,11,17,27,28,32,125
23233,7,10,11,20,21,27,32,128
23539,1,4,8,18,23,27,33,114
23920,7,10,11,16,21,25,27,117
23921,2,8,9,13,17,24,27,100
24135,7,8,10,14,27,29,34,129
24289,4,9,10,14,23,25,29,114
24308,4,6,15,17,21,24,35,122
24555,3,12,16,18,26,29,33,137
24644,5,6,9,19,22,25,31,117
24731,6,7,11,13,22,26,31,116
25198,1,4,7,18,25,26,29,110
25235,7,14,17,18,19,24,31,130
25270,3,7,8,18,22,24,33,115
25339,2,7,11,17,23,26,31,117
25802,2,3,11,16,17,27,31,107
25878,5,7,8,13,17,26,27,103
25900,6,9,17,20,26,29,30,137
25906,7,9,11,16,17,27,30,117
25959,7,10,11,13,26,27,35,129
26039,3,8,9,18,29,30,33,130
26327,1,5,11,16,22,30,34,119
26406,3,7,8,20,25,31,32,126
26448,1,9,16,20,29,32,35,142
26536,6,10,16,17,23,27,30,129
26598,2,7,8,24,27,31,35,134
26926,1,9,10,14,19,24,25,102
27043,1,4,11,18,24,27,28,113
27069,5,7,11,18,26,27,29,123
27073,2,9,11,13,21,27,32,115
27357,3,5,16,20,22,26,29,121
27409,2,7,14,18,21,24,27,113
27475,8,9,14,18,27,28,29,133
27560,2,9,17,18,22,24,29,121
27698,4,9,10,13,26,27,32,121
27740,5,9,14,20,21,31,35,135
27766,9,14,16,18,19,24,33,133
27788,2,14,16,20,21,23,29,125
27946,2,6,14,20,21,29,33,125
28208,2,7,8,16,24,25,29,111
28376,2,7,8,11,24,27,32,111
28386,2,7,8,13,17,29,35,111
28412,7,8,11,20,26,29,35,136
28459,10,14,16,17,24,27,35,143
28528,5,8,11,18,23,27,30,122
29085,4,8,10,12,25,27,33,119
29236,6,8,11,18,22,27,33,125
29382,9,10,14,16,25,29,35,138
29550,1,3,7,18,22,24,33,108
29680,2,9,14,18,21,24,29,117
29753,1,9,10,13,19,24,33,109
29827,5,7,10,17,22,23,27,111
29886,3,4,10,16,19,23,27,102
29929,2,9,11,13,19,25,28,107
29954,3,14,15,16,23,27,29,127
30030,3,7,9,17,22,24,27,109
30083,1,5,11,20,22,24,27,110
30187,1,7,16,20,22,24,25,115
30318,3,9,18,19,23,29,34,135
30446,5,9,11,16,17,23,34,115
30581,8,14,18,20,21,25,33,139
30691,6,9,14,20,21,24,31,125
30884,7,12,15,17,24,28,30,133
31135,5,10,11,14,25,27,32,124
31171,6,10,16,17,25,27,31,132
31345,1,7,9,20,22,30,34,123
31412,4,8,17,20,26,31,33,139
31490,2,6,7,19,22,25,27,108
31532,2,7,10,17,19,23,29,107
31835,9,10,14,20,27,31,35,146
31934,8,12,17,20,27,29,33,146
32126,3,6,9,14,25,29,33,119
32517,9,10,16,19,27,29,33,143
33184,4,9,11,17,21,24,35,121
33327,1,9,16,20,22,31,34,133
33338,4,9,15,18,19,24,32,121
33419,7,8,11,14,26,27,29,122
33496,2,9,16,17,21,27,35,127
33883,3,4,8,13,21,27,31,107
34010,9,10,11,13,23,26,29,121
34173,2,14,16,20,23,25,27,127
34352,4,7,9,19,24,28,34,125
34669,4,7,9,13,17,24,27,101
34680,6,9,10,14,29,30,35,133
34848,6,7,16,18,21,24,25,117
34940,1,5,7,20,27,32,33,125
35169,3,9,14,24,25,29,32,136
35244,3,8,16,20,22,31,33,133
35270,1,5,11,18,19,24,27,105
35312,2,8,15,16,19,27,29,116
35346,2,9,18,19,25,29,31,133
35462,9,12,15,19,25,28,29,137
35517,1,5,11,14,22,25,29,107
35542,9,10,17,20,21,27,32,136
35668,5,9,15,16,17,24,33,119
35863,7,12,17,20,23,24,31,134
35876,2,4,11,19,21,25,33,115
36060,1,7,9,11,23,24,34,109
36091,4,6,15,19,25,30,31,130
36285,7,10,16,20,23,26,27,129
36542,1,4,8,18,21,27,30,109
36957,1,3,7,16,22,23,29,101
37256,3,4,8,18,25,30,31,119
37316,5,8,16,18,22,31,33,133
37357,1,5,17,20,26,31,33,133
37532,1,7,9,16,24,30,34,121
37837,4,12,17,18,21,30,33,135
37870,3,8,9,13,22,27,32,114
37995,2,7,11,19,22,25,28,114
38154,2,7,11,14,27,28,33,122
38249,1,7,8,17,26,27,31,117
38321,4,8,10,18,21,27,31,119
38744,1,5,15,18,24,29,33,125
38790,1,14,16,17,23,26,27,124
39241,1,7,9,24,29,30,34,134
39258,7,12,14,17,23,24,27,124
39368,1,5,7,20,24,29,30,116
39409,1,7,16,18,22,26,31,121
39442,4,8,15,16,23,29,32,127
39487,7,8,10,20,25,31,35,136
39524,6,10,15,16,17,25,27,116
39585,7,8,10,20,23,26,27,121
39655,4,8,17,20,21,27,32,129
39902,5,7,15,19,26,29,32,133
40146,3,8,15,20,22,26,29,123
40154,4,9,16,20,21,25,31,126
40192,9,10,14,20,23,27,32,135
40281,1,7,9,20,23,24,34,118
40456,8,9,11,16,17,29,33,123
40479,9,12,16,20,21,24,27,129
40498,1,3,7,14,22,31,33,111
41096,9,10,14,16,17,27,30,123
41155,4,12,16,19,22,23,27,123
41251,5,7,18,19,24,28,29,130
41374,7,8,11,18,19,24,25,112
41473,6,9,10,16,17,27,34,119
41477,7,8,11,17,22,25,35,125
41594,9,10,14,20,21,26,27,127
41668,1,5,7,13,22,29,34,111
41808,2,6,15,16,17,23,31,110
41916,2,6,7,19,24,25,32,115
41959,1,14,16,19,22,23,27,122
41978,2,4,16,19,25,28,29,123
42122,1,9,10,13,22,25,31,111
42157,1,4,8,11,22,28,35,109
42498,6,12,17,18,26,31,35,145
42564,3,8,14,16,17,27,31,116
42643,7,9,11,19,21,26,32,125
42646,7,9,14,20,21,27,31,129
42647,5,6,7,16,17,23,27,101
43013,2,4,10,12,19,25,29,101
43128,5,12,16,19,22,26,27,127
43266,4,10,14,18,21,23,29,119
43712,3,14,18,19,22,25,33,134
43767,4,5,9,14,25,31,35,123
43943,1,7,8,11,27,28,30,112
44120,1,5,7,12,22,31,32,110
44453,2,7,11,20,26,27,32,125
44873,8,9,10,13,26,29,32,127
44887,3,7,9,13,22,26,27,107
44981,4,10,16,17,23,27,35,132
45166,9,10,11,17,21,25,28,121
45173,5,8,14,20,23,26,27,123
45286,6,7,11,16,26,27,33,126
45429,1,5,9,16,22,23,27,103
45621,2,7,10,16,17,29,33,114
45778,2,5,11,16,19,23,29,105
45842,1,4,8,18,25,31,33,120
45851,2,6,17,18,24,29,33,129
46068,1,10,15,16,19,24,27,112
46210,8,9,11,13,19,26,29,115
46453,1,3,11,20,25,26,29,115
46584,1,10,15,16,23,24,27,116
46755,4,8,11,17,24,27,35,126
46783,3,12,16,19,22,27,34,133
46862,9,12,17,18,22,25,32,135
46936,1,9,11,18,22,28,29,118
46982,1,8,16,20,21,29,35,130
47219,2,5,16,20,21,26,27,117
47386,1,7,11,12,27,28,35,121
47656,1,7,15,18,22,25,29,117
47691,3,6,10,20,26,27,33,125
47757,2,10,11,13,17,23,27,103
47907,6,12,16,17,27,29,35,142
47938,6,9,16,19,22,26,31,129
47964,5,12,16,17,23,27,34,134
48030,5,7,14,18,24,25,27,120
48114,2,4,7,11,17,29,31,101
48199,4,8,15,19,25,27,33,131
48206,3,7,9,17,29,30,32,127
48358,4,8,18,19,21,23,27,120
48552,4,5,16,19,22,23,31,120
48663,6,7,17,18,21,26,27,122
48675,7,8,9,19,23,24,25,115
48765,4,6,8,18,27,29,33,125
48785,7,14,18,24,25,28,29,145
48861,2,6,9,20,26,29,33,125
48871,7,8,9,13,17,24,28,106
48892,1,7,8,18,29,32,33,128
49107,9,14,15,20,23,29,33,143
49472,2,4,11,19,21,25,29,111
49528,3,7,11,20,24,26,27,118
49620,9,14,15,20,23,24,31,136
49903,1,7,17,20,23,27,28,123
49935,7,12,14,17,21,23,27,121
50115,2,7,8,11,17,30,32,107
50161,2,9,15,19,25,28,29,127
50191,4,8,9,16,17,23,31,108
50225,2,10,15,20,26,27,31,131
50337,4,6,14,18,27,29,35,133
50347,5,7,16,18,22,26,33,127
50471,3,8,18,20,23,27,33,132
50495,4,5,9,11,25,26,33,113
50576,1,9,15,20,24,30,35,134
50591,5,9,11,16,19,28,33,121
50982,4,8,9,14,24,29,35,123
51263,2,10,16,17,25,29,35,134
51361,4,10,17,20,21,28,31,131
51539,5,7,16,20,26,27,33,134
51647,5,9,11,13,26,31,34,129
51652,8,9,18,20,24,29,33,141
51682,1,5,16,17,22,28,31,120
51997,1,5,10,16,27,29,35,123
52053,2,7,17,18,22,24,31,121
52100,1,3,7,14,17,27,34,103
52107,3,7,8,20,26,27,28,119
52140,5,9,16,18,21,24,32,125
52339,7,10,16,20,21,23,29,126
52458,4,9,15,18,19,30,33,128
53203,2,6,11,16,17,30,33,115
53360,9,10,14,20,27,29,31,140
53380,3,7,16,24,26,27,33,136
53794,7,12,14,18,25,29,35,140
53860,1,5,9,18,24,31,34,122
53927,2,7,11,17,26,28,34,125
54230,2,8,9,18,23,24,27,111
54459,8,12,18,19,22,31,33,143
54637,4,8,9,14,17,25,27,104
54693,7,8,11,16,22,28,35,127
54750,6,9,11,13,19,28,33,119
54877,8,12,16,17,22,25,29,129
54955,2,6,16,20,21,29,35,129
55232,8,12,15,16,23,29,32,135
55262,5,7,11,18,19,27,28,115
55476,1,5,9,18,22,28,33,116
55552,1,7,18,20,21,27,31,125
56003,2,8,11,12,22,25,33,113
56226,2,4,18,19,25,28,29,125
56451,1,4,15,19,25,27,34,125
56982,5,7,11,19,22,24,34,122
56996,1,12,16,17,19,23,27,115
57051,2,8,9,13,22,31,32,117
57149,2,7,11,12,26,27,32,117
57291,5,7,11,19,22,29,32,125
57385,2,7,11,17,26,31,32,126
57451,9,12,17,18,21,30,32,139
57460,4,5,7,17,21,27,28,109
57491,7,14,15,20,21,24,29,130
57596,2,3,8,11,22,31,35,112
58140,3,8,16,20,22,23,27,119
58250,7,14,18,20,23,27,30,139
58313,5,8,11,20,22,25,29,120
58365,7,9,10,13,19,29,34,121
58799,1,6,17,18,27,29,33,131
58931,1,5,11,16,22,25,30,110
58945,2,7,8,11,19,25,35,107
58965,2,4,10,18,19,23,25,101
59048,2,6,9,18,21,24,33,113
59175,1,5,14,16,22,30,35,123
59210,2,10,11,19,23,24,25,114
59314,2,8,9,16,29,31,33,128
59479,1,7,11,13,22,26,27,107
59509,8,9,11,13,19,26,34,120
59604,1,5,15,16,22,23,28,110
59818,4,9,14,18,19,25,35,124
59845,1,12,16,20,26,27,33,135
60078,8,12,16,20,21,23,27,127
60107,1,14,18,24,27,29,33,146
60209,4,9,11,13,21,27,32,117
60295,3,5,9,19,22,24,35,117
60404,3,7,9,14,21,29,32,115
60466,1,6,14,16,22,31,35,125
60515,3,9,17,18,22,24,35,128
60986,7,9,14,20,26,27,31,134
61472,3,9,10,13,17,31,34,117
61544,5,8,16,20,25,28,31,133
62009,2,5,7,11,26,29,33,113
62176,5,6,9,12,19,25,29,105
62289,4,14,15,18,21,27,35,134
62442,4,9,16,17,22,26,31,125
62466,1,9,15,16,24,30,34,129
62566,3,12,16,18,19,24,27,119
62579,1,6,18,24,25,28,33,135
62718,1,7,9,19,24,28,33,121
62862,4,8,16,20,25,27,33,133
62948,4,8,9,16,23,29,30,119
63138,1,5,11,20,27,28,33,125
63201,6,14,15,16,25,29,31,136
63230,1,14,16,20,25,30,31,137
63255,4,12,15,18,19,29,30,127
63273,1,3,11,16,22,30,34,117
63520,1,9,16,20,24,30,33,133
63638,1,5,7,18,24,32,34,121
63644,2,3,8,11,23,27,35,109
63656,2,8,15,16,24,29,33,127
63670,7,8,9,17,23,24,27,115
64000,7,12,17,18,19,28,32,133
64126,1,5,10,13,22,27,33,111
64127,6,7,9,13,24,26,33,118
64653,3,8,9,20,21,29,33,123
65009,2,5,7,14,25,29,35,117
65058,2,7,14,24,25,27,31,130
65304,1,9,18,20,25,27,31,131
65384,2,5,11,13,21,25,32,109
65413,8,9,11,16,21,25,27,117
65526,3,7,9,12,21,29,32,113
65795,1,4,8,13,17,27,33,103
65871,1,12,16,19,22,25,35,130
66037,1,5,16,20,22,27,33,124
66073,4,8,16,19,26,27,33,133
66078,1,7,18,20,23,27,31,127
66124,4,10,14,16,21,27,35,127
66209,2,8,11,13,23,27,29,113
66228,9,10,14,20,23,24,27,127
66293,5,7,8,11,22,31,32,116
66877,1,7,17,18,19,28,32,122
67201,2,10,16,17,22,25,29,121
67323,3,8,15,16,22,27,31,122
67432,1,5,11,20,24,25,32,118
67583,1,7,11,14,22,31,35,121
67606,3,9,14,20,26,30,31,133
67820,3,9,16,17,21,24,32,122
67998,4,5,16,20,21,27,31,124
68147,3,8,16,20,21,27,34,129
68314,5,8,11,16,23,27,30,120
68461,1,7,14,18,29,30,35,134
68707,6,7,18,19,25,27,29,131
68726,6,10,17,18,27,29,33,140
68991,1,7,11,16,22,26,32,115
69050,1,9,16,20,25,26,33,130
69051,1,4,7,20,24,25,30,111
69152,7,14,16,20,25,26,29,137
69192,4,14,18,19,25,29,31,140
69206,5,7,11,20,26,27,32,128
69598,2,5,9,20,21,27,30,114
69671,7,10,17,20,21,24,27,126
69707,5,8,9,13,24,29,35,123
69832,4,14,18,19,25,26,31,137
69965,3,5,8,16,22,26,31,111
70131,8,9,11,13,19,26,32,118
70166,2,8,11,12,17,25,34,109
70325,1,7,9,12,22,29,33,113
70326,4,9,14,17,25,27,31,127
70361,1,7,18,19,24,27,31,127
70397,2,7,17,18,22,23,25,114
70438,4,14,17,18,21,23,31,128
70660,2,3,16,19,22,26,27,115
70758,5,7,11,16,25,26,27,117
70840,1,7,8,11,27,28,32,114
70954,1,14,15,16,21,24,25,116
71124,1,3,17,20,24,26,30,121
71140,2,7,11,12,19,25,31,107
71214,1,7,18,20,29,32,33,140
71445,4,10,17,18,19,23,29,120
71500,7,9,11,19,22,26,28,122
71504,5,8,16,20,23,27,29,128
71628,1,4,14,16,22,31,35,123
71783,1,5,8,11,22,30,35,112
71785,9,14,16,20,24,25,29,137
71890,1,8,17,20,21,26,34,127
71944,4,8,17,18,19,23,25,114
72271,2,9,16,19,23,29,30,128
72488,4,5,11,18,19,23,25,105
72598,1,9,16,17,23,27,32,125
72700,2,5,7,11,17,28,32,102
72707,2,4,8,12,23,29,35,113
72715,5,9,17,18,24,25,29,127
72857,1,5,11,14,22,24,25,102
73218,7,10,11,17,22,30,35,132
73308,2,5,16,17,23,27,35,125
73476,2,9,11,19,23,24,25,113
73483,9,10,16,17,21,27,32,132
73558,9,10,14,20,25,29,32,139
74016,4,10,17,18,22,25,33,129
74100,1,4,15,24,25,29,35,133
74137,5,7,9,11,24,26,33,115
74177,4,6,17,18,21,24,25,115
74228,3,4,7,19,27,30,33,123
74324,7,9,11,17,24,29,34,131
74403,1,7,9,14,22,25,29,107
74427,8,9,10,16,21,29,33,126
74534,4,9,10,17,21,27,35,123
74772,1,14,16,20,27,31,33,142
74840,7,10,14,17,23,27,33,131
74888,5,9,11,20,25,26,28,124
75007,9,12,14,17,25,27,31,135
75174,4,8,14,19,23,25,27,120
75261,1,9,14,20,25,29,34,132
75306,5,9,17,20,26,27,32,136
75321,1,10,15,16,19,27,29,117
75393,1,6,9,20,22,26,29,113
75437,1,7,18,19,22,25,30,122
75452,4,9,11,13,17,24,25,103
75579,2,8,16,19,29,30,33,137
75637,7,12,18,20,21,25,32,135
75771,1,7,9,11,21,28,32,109
75922,1,7,11,17,22,28,29,115
76059,1,3,9,20,24,25,31,113
76118,10,12,15,16,19,24,25,121
76186,7,9,10,19,25,29,34,133
76384,1,7,17,20,24,25,28,122
76708,3,9,14,18,22,23,33,122
76840,7,12,16,17,22,25,27,126
76978,3,4,9,18,25,26,30,115
76994,5,9,11,18,21,24,30,118
77035,4,7,15,16,22,26,31,121
77250,1,10,16,20,21,24,29,121
77312,9,10,14,20,25,27,30,135
77606,5,8,9,20,24,30,35,131
77709,1,4,9,20,23,26,27,110
77831,4,7,8,18,19,25,29,110
77939,2,6,11,19,22,25,29,114
78474,1,8,9,12,27,29,35,121
78537,5,9,18,19,23,24,35,133
78543,3,12,16,19,22,29,35,136
78590,6,9,11,20,21,25,31,123
78646,3,5,11,18,23,26,27,113
78832,2,8,15,16,25,29,32,127
79131,3,4,8,20,21,26,27,109
79237,4,7,10,11,26,27,30,115
79412,3,7,15,20,21,28,29,123
79563,2,7,8,12,17,25,31,102
79908,6,8,16,20,21,29,35,135
80253,9,14,15,18,23,24,30,133
80616,1,8,17,20,21,26,27,120
80909,2,3,16,17,25,31,35,129
81025,7,9,11,13,21,28,34,123
81125,2,8,9,13,27,29,34,122
81509,5,6,10,16,17,27,29,110
81613,8,9,16,19,23,25,29,129
81643,5,8,9,16,24,25,31,118
81710,5,14,15,19,24,25,33,135
81742,7,8,15,19,24,25,30,128
81818,1,3,9,13,22,31,32,111
81907,1,7,16,18,22,27,30,121
82050,2,7,10,11,17,25,32,104
82338,3,8,10,11,25,27,31,115
82402,5,8,10,16,24,27,31,121
82412,1,6,10,20,27,30,33,127
82415,7,14,17,24,26,27,30,145
82432,3,9,10,12,19,25,29,107
82602,4,7,14,18,19,25,33,120
82629,8,12,17,20,23,31,33,144
83246,2,4,8,16,21,23,27,101
83439,2,10,16,20,21,25,27,121
83557,1,10,16,20,24,27,33,131
83661,2,8,11,18,27,31,33,130
83663,1,5,17,20,26,27,28,124
83667,1,7,11,14,17,26,27,103
83866,9,14,17,20,24,27,31,142
83883,4,8,9,16,23,25,31,116
84541,1,9,16,20,22,30,31,129
84741,5,8,17,18,24,29,33,134
84789,4,9,11,13,17,29,34,117
84830,6,8,10,16,25,27,29,121
84870,1,4,7,19,27,28,31,117
85011,4,8,16,19,22,25,27,121
85046,2,8,11,12,19,25,31,108
85051,8,9,15,19,24,31,35,141
85285,4,12,14,20,25,29,33,137
85390,5,9,16,19,22,27,29,127
85417,5,6,9,20,26,31,33,130
85558,7,8,9,13,19,28,29,113
85684,3,6,8,20,23,26,27,113
85878,1,3,18,24,25,28,33,132
86006,4,6,8,19,25,27,35,124
86060,2,7,11,16,17,28,34,115
86117,5,10,16,19,22,23,31,126
86302,9,14,15,24,25,28,32,147
86649,3,9,14,24,25,30,34,139
86654,4,6,8,13,19,25,27,102
86785,1,8,11,16,17,27,31,111
87172,7,9,15,24,26,30,32,143
87392,3,7,9,14,29,32,35,129
87525,7,8,15,18,22,23,28,121
88034,2,5,8,13,29,31,33,121
88068,2,7,8,13,17,24,33,104
88092,2,9,10,16,17,27,31,112
88302,6,7,9,17,23,24,28,114
88683,3,4,8,16,19,27,33,110
88927,7,14,15,20,25,29,31,141
89139,2,7,9,14,23,29,33,117
89334,5,9,10,20,26,27,31,128
89346,6,14,16,17,23,27,32,135
89417,2,10,11,14,29,32,35,133
89426,2,7,8,13,25,29,34,118
89832,9,10,16,18,26,29,33,141
89833,8,14,15,18,29,31,33,148
89865,4,8,17,18,27,29,35,138
89915,4,12,14,16,21,27,31,125
90052,1,7,11,19,22,26,34,120
90276,3,7,15,17,26,29,32,129
90286,1,3,7,19,22,26,32,110
90413,7,9,15,19,29,30,34,143
90914,7,8,9,24,27,30,34,139
91111,4,8,9,13,27,28,33,122
91223,5,9,16,17,24,26,32,129
91542,4,5,9,14,25,29,31,117
91566,4,8,15,19,25,31,32,134
91717,3,7,10,18,21,29,35,123
91914,8,9,14,18,29,30,35,143
92018,2,4,8,11,22,25,33,105
92529,3,5,7,18,22,26,32,113
92561,2,4,17,18,25,31,35,132
92652,4,14,15,18,25,31,32,139
92696,7,9,11,20,24,26,33,130
92841,3,10,14,20,25,26,31,129
92946,5,9,16,19,24,25,34,132
93156,1,4,7,19,23,27,28,109
93245,8,9,17,18,21,24,34,131
93256,6,9,14,20,21,24,29,123
93351,6,7,17,20,22,26,27,125
93463,1,5,14,20,23,27,33,123
93578,2,7,11,16,17,24,25,102
93715,2,4,11,14,21,25,27,104
93771,7,9,14,16,23,29,33,131
94072,1,3,7,20,21,24,29,105
94112,1,5,16,18,22,23,32,117
94400,5,9,10,11,26,31,35,127
94558,5,6,17,18,27,31,33,137
94597,7,8,18,20,24,27,31,135
94725,9,14,15,18,25,27,29,137
94796,7,9,11,13,26,28,31,125
94820,1,5,11,18,19,24,29,107
95165,1,7,9,20,21,24,32,114
95225,5,8,9,11,24,26,35,118
95250,4,7,10,19,22,26,29,117
95293,9,14,17,20,24,28,35,147
95375,8,10,18,20,23,29,33,141
95593,5,9,16,17,22,24,30,123
96273,5,10,11,19,22,23,35,125
96278,5,6,15,24,25,26,30,131
96288,5,7,18,20,21,24,25,120
96305,8,10,16,24,27,31,33,149
96323,3,7,9,18,21,24,34,116
96865,3,7,14,20,22,25,29,120
96885,1,6,10,20,26,27,29,119
97107,2,4,8,19,25,27,34,119
97410,5,9,14,17,19,24,25,113
97455,5,14,16,20,21,27,29,132
97565,8,9,11,12,17,25,27,109
97753,4,5,9,12,25,26,31,112
97821,8,9,11,13,21,24,30,116
97906,3,7,14,20,22,26,27,119
97992,2,9,18,19,24,25,28,125
98009,6,7,9,11,17,27,32,109
98051,2,8,11,24,25,28,33,131
98095,3,4,7,14,21,26,27,102
98214,3,6,7,11,17,27,32,103
98259,3,7,8,18,24,25,32,117
98286,5,7,14,20,24,29,33,132
98358,4,14,17,18,26,27,33,139
98865,2,3,8,11,25,28,29,106
99123,1,5,10,20,23,26,29,114
99162,4,5,9,11,25,26,32,112
99324,1,9,15,20,22,26,27,120
99418,5,9,17,20,22,28,29,130
99420,2,9,16,19,25,29,33,133
99441,9,10,11,14,21,25,27,117
99456,9,12,15,16,17,29,31,129
99555,5,9,11,16,21,32,34,128
99721,3,7,9,19,22,26,27,113
99773,1,9,16,18,22,23,27,116
99819,3,12,16,19,25,27,29,131
99832,2,10,11,19,23,25,31,121
99842,4,7,8,24,27,29,33,132
99974,4,6,15,19,25,31,32,132
100118,6,9,14,20,24,27,35,135
100136,9,14,15,20,24,29,33,144
100138,9,12,15,16,19,24,33,128
100141,1,9,11,18,22,23,28,112
100149,2,6,7,12,17,31,33,108
100159,5,7,11,17,22,28,34,124
100208,2,6,11,14,21,29,35,118
100236,2,9,18,20,21,25,27,122
100240,1,4,10,18,22,25,31,111
100308,1,5,9,18,22,24,27,106
100856,10,12,14,20,25,29,33,143
101073,9,12,14,20,27,29,33,144
101088,2,6,9,11,26,32,35,121
101313,2,14,17,18,22,23,33,129
101355,3,5,9,16,21,24,31,109
101497,3,9,14,20,25,31,35,137
101541,3,9,14,18,22,23,34,123
101566,7,8,11,17,23,27,28,121
101661,1,3,18,19,22,25,33,121
101959,3,7,15,24,26,32,34,141
102044,5,7,11,19,22,23,30,117
102224,4,10,17,18,23,29,33,134
102385,2,12,15,16,17,23,29,114
102449,5,7,8,18,23,27,29,117
102608,4,8,15,20,26,29,33,135
102783,4,7,8,12,21,27,32,111
102910,2,4,8,13,25,29,30,111
103064,7,9,10,13,17,31,32,119
103269,4,5,9,20,24,26,27,115
103457,3,4,14,20,23,24,27,115
103482,7,12,16,17,23,27,30,132
103508,2,4,7,13,25,26,29,106
103553,6,7,9,11,17,26,31,107
103560,1,12,18,24,29,32,33,149
103724,2,7,11,24,26,27,32,129
103839,2,8,11,13,19,23,27,103
103972,3,8,9,18,22,23,30,113
103976,5,14,16,18,24,25,27,129
104097,4,9,11,17,25,28,32,126
104108,8,12,15,20,26,29,33,143
104111,1,7,15,18,22,29,34,126
104306,5,6,10,20,23,26,27,117
104323,4,6,15,19,24,25,30,123
104597,1,5,14,16,22,27,35,120
104848,3,7,9,19,24,28,33,123
104947,5,7,14,20,26,27,31,130
104963,7,8,10,18,29,31,35,138
105193,4,12,14,17,23,25,27,122
105194,9,10,14,16,22,25,31,127
105252,2,8,16,17,22,29,33,127
105336,2,9,16,17,22,25,29,120
105626,6,7,10,11,26,27,33,120
105707,2,4,7,13,17,29,30,102
105755,3,7,14,24,27,30,34,139
105849,2,7,14,18,25,29,31,126
106152,4,8,9,12,29,30,35,127
106263,2,4,7,11,21,25,31,101
106278,1,7,11,16,22,31,33,121
106354,7,9,10,11,19,25,34,115
106566,2,10,16,17,21,27,29,122
107017,1,7,16,24,27,28,30,133
107182,6,7,15,17,23,27,30,125
107478,5,9,17,18,24,25,33,131
107767,5,10,16,18,26,29,33,137
107786,4,12,17,20,21,27,35,136
107985,4,8,9,18,19,25,33,116
108152,1,9,10,20,24,25,30,119
108173,4,9,11,16,22,26,31,119
108239,1,6,16,20,22,23,29,117
108244,1,7,16,20,27,29,32,132
108322,1,7,17,20,21,29,34,129
108553,1,7,11,12,27,31,32,121
108753,10,12,16,19,23,24,27,131
108825,1,12,16,17,22,28,29,125
108989,6,14,16,20,21,27,33,137
109326,6,12,15,16,17,23,29,118
109660,6,7,9,11,21,26,32,112
109748,5,6,7,11,17,27,28,101
109813,3,4,8,13,25,27,31,111
110198,4,9,15,18,19,27,34,126
110487,1,12,17,18,21,31,33,133
110554,2,6,11,17,26,29,35,126
110574,7,14,18,24,27,28,31,149
110665,3,5,18,24,26,27,31,134
110737,1,10,16,20,25,27,35,134
110774,1,7,16,20,26,27,29,126
111003,6,10,16,17,22,27,33,131
111384,8,14,16,18,23,27,29,135
111714,3,7,9,17,26,31,32,125
111740,4,5,10,18,21,25,30,113
111745,1,12,16,20,21,29,35,134
112101,8,10,11,12,25,27,31,124
112217,9,10,15,17,25,29,34,139
112505,4,9,10,14,25,29,34,125
112635,3,8,9,18,23,24,28,113
112646,4,8,10,20,25,31,33,131
112671,3,7,9,24,26,27,32,128
113051,7,8,10,20,23,27,29,124
113487,4,6,11,13,17,27,28,106
113498,5,12,16,19,22,28,29,131
113546,1,7,8,11,25,27,28,107
113553,4,7,11,16,22,26,27,113
113651,1,6,7,18,26,29,30,117
113758,8,9,14,18,26,29,33,137
113766,4,7,8,18,25,27,31,120
114031,1,6,11,20,25,31,35,129
114109,4,8,9,16,22,25,27,111
114150,1,7,9,13,24,28,33,115
114269,9,14,15,19,24,25,32,138
114308,4,7,10,14,19,27,32,113
114490,1,7,15,17,19,28,30,117
114575,1,7,18,24,27,30,31,138
114592,7,10,16,17,23,27,34,134
114634,9,10,11,24,26,30,35,145
114648,1,5,14,16,21,27,29,113
114890,1,9,16,17,21,26,32,122
114970,4,9,17,20,24,27,30,131
115041,3,7,14,20,22,24,29,119
115046,1,4,11,18,22,28,35,119
115107,4,5,11,20,21,25,32,118
115149,5,9,10,11,25,26,33,119
115318,4,10,15,17,25,29,31,131
115332,3,7,9,19,22,24,30,114
115423,3,4,7,14,21,27,31,107
115458,1,8,16,20,23,28,29,125
115533,1,5,10,16,27,28,29,116
115584,2,7,9,11,26,32,33,120
115600,4,9,15,19,24,30,35,136
115642,1,6,7,16,22,26,31,109
115888,2,4,8,24,25,29,35,127
116049,1,4,11,13,17,27,32,105
116114,2,8,11,20,29,31,35,136
116193,6,8,16,17,23,27,29,126
116444,3,9,14,18,26,29,32,131
116511,9,14,17,18,23,26,29,136
116672,1,7,9,18,22,26,30,113
116706,8,9,10,17,23,27,35,129
116852,5,7,8,11,22,23,30,106
117081,5,12,16,20,25,26,29,133
117173,3,9,17,20,21,24,33,127
117261,3,8,9,13,23,24,31,111
117628,2,5,16,19,25,29,33,129
117687,7,14,18,24,25,26,27,141
117703,7,9,10,11,21,27,28,113
117836,9,14,17,18,19,25,28,130
117876,8,9,16,18,22,31,35,139
118100,8,9,11,13,19,28,30,118
118143,5,12,16,17,22,27,29,128
118298,1,5,9,18,22,24,33,112
118550,8,9,17,24,25,28,34,145
118913,2,5,11,16,17,30,34,115
118945,7,12,17,18,22,23,30,129
118981,6,9,11,16,21,25,31,119
119052,4,14,15,17,21,27,35,133
119113,6,8,9,18,22,25,31,119
119189,5,7,11,17,24,27,28,119
119275,2,9,15,16,19,24,29,114
119373,7,10,17,24,27,30,34,149
119393,3,8,9,20,27,28,31,126
119466,1,5,7,18,22,25,29,107
119527,7,10,11,17,27,28,31,131
119767,9,12,17,18,22,25,33,136
119860,2,8,9,14,21,24,25,103
120406,1,6,9,20,26,30,31,123
120507,8,9,16,20,21,27,35,136
120508,1,5,9,20,25,26,32,118
120524,1,10,11,16,23,24,27,112
120750,4,7,15,19,22,27,33,127
120936,1,5,7,18,27,29,30,117
121237,4,6,8,20,21,25,27,111
121302,2,9,18,19,25,29,32,134
121322,1,9,16,24,25,28,34,137
121750,1,5,7,18,27,29,32,119
121792,2,7,14,18,29,32,35,137
121807,4,9,10,14,17,29,35,118
121948,1,7,15,18,24,27,31,123
122113,1,9,11,13,19,32,34,119
122275,5,9,16,19,24,30,32,135
122410,1,7,11,24,27,31,32,133
122508,2,5,9,18,24,26,35,119
122592,7,14,17,20,23,24,28,133
122609,2,4,10,19,21,25,27,108
122792,3,9,18,19,22,26,33,130
123012,5,7,15,19,22,28,31,127
123013,4,7,17,18,23,27,31,127
123178,2,4,16,17,23,25,29,116
123192,4,5,18,20,21,24,29,121
123197,7,8,11,16,17,27,34,120
123222,3,4,17,20,23,27,32,126
123589,2,7,18,19,23,25,29,123
123814,3,8,9,20,22,24,25,111
124425,9,14,15,20,27,28,32,145
124571,4,10,11,19,25,27,31,127
124629,1,6,8,18,23,29,33,118
124666,1,6,16,18,24,29,33,127
124679,1,4,10,18,21,23,25,102
124720,2,6,11,16,21,29,35,120
124758,1,4,9,20,26,29,30,119
124788,1,7,11,14,22,26,27,108
125159,7,10,15,19,22,27,33,133
125290,3,10,14,20,25,26,29,127
125343,1,8,16,20,21,27,31,124
125381,5,7,8,11,22,31,35,119
125502,7,9,10,14,19,24,25,108
125538,7,8,15,18,22,25,31,126
125553,3,4,9,20,24,26,35,121
125703,2,7,8,17,24,28,29,115
125742,1,7,9,18,22,29,32,118
125806,2,12,15,16,21,24,29,119
126104,5,14,16,20,27,29,32,143
126119,2,6,9,13,19,23,29,101
126151,2,8,11,18,22,29,35,125
126258,2,7,11,12,17,23,29,101
126265,6,8,14,16,17,23,27,111
126426,5,8,17,18,22,24,33,127
126429,4,8,10,16,19,27,35,119
126741,4,8,9,14,27,32,35,129
126788,8,9,18,19,25,29,31,139
126798,1,8,14,20,26,27,31,127
126808,2,3,8,18,22,31,33,117
126836,8,9,17,18,21,23,25,121
126863,4,7,9,19,25,28,29,121
127112,8,9,15,20,29,31,33,145
127508,2,3,7,19,22,24,28,105
127656,2,7,14,18,24,29,31,125
127690,1,5,8,16,22,31,33,116
127801,1,5,7,16,22,25,32,108
127970,1,7,9,20,24,29,31,121
128462,9,14,18,20,24,27,33,145
128482,3,9,17,18,21,27,32,127
128551,4,12,18,19,22,31,35,141
128813,2,7,14,18,19,23,29,112
128965,3,14,15,16,19,25,29,121
129101,3,10,16,24,26,27,31,137
129377,1,5,9,16,22,25,27,105
129429,6,8,9,20,29,31,35,138
129972,7,8,10,11,27,28,33,124
130000,4,6,10,20,21,25,27,113
130263,5,9,14,17,29,30,35,139
130270,4,5,10,18,21,25,31,114
130450,9,10,14,20,21,27,32,133
131206,1,4,15,18,19,25,28,110
131249,3,7,18,19,24,25,30,126
131349,2,8,16,17,21,24,25,113
131514,3,7,18,19,22,24,35,128
131543,2,7,11,24,25,26,32,127
131551,9,10,16,20,21,31,33,140
131757,7,14,17,18,24,29,31,140
132023,4,8,11,14,25,27,34,123
132094,3,12,17,18,26,29,33,138
132553,8,14,15,16,22,25,29,129
132572,3,4,15,16,22,26,31,117
132616,1,4,9,13,24,30,35,116
132665,1,9,14,18,19,24,30,115
132693,3,7,16,19,22,25,27,119
132836,2,4,10,14,25,31,33,119
133107,4,10,11,18,21,25,29,118
133351,4,8,9,20,21,27,28,117
133398,5,8,9,12,22,25,31,112
133560,1,7,15,17,21,26,28,115
133828,1,5,8,16,22,25,28,105
134350,6,12,17,20,21,26,31,133
134517,1,7,11,17,22,30,35,123
134571,1,9,10,20,24,30,31,125
134579,1,6,9,18,24,28,31,117
134768,1,7,10,13,22,24,28,105
134770,4,9,17,18,19,23,34,124
135176,3,7,8,14,22,25,31,110
135291,1,7,11,14,27,28,31,119
135570,1,7,15,19,22,26,28,118
136200,4,14,15,19,24,25,32,133
136301,2,3,9,13,24,26,33,110
136306,8,10,16,17,23,27,30,131
136832,8,9,18,24,25,31,35,150
136975,7,8,11,17,27,29,32,131
137000,4,8,11,13,17,27,34,114
137041,6,7,8,17,23,27,28,116
137061,7,9,14,24,27,29,33,143
137180,1,5,9,18,24,30,32,119
137222,2,7,16,19,23,29,30,126
137647,2,7,11,12,21,24,27,104
137683,5,9,14,20,24,31,33,136
138168,2,3,8,13,23,29,33,111
138270,7,14,15,20,22,26,29,133
138276,5,8,11,20,23,27,35,129
138313,2,6,11,14,17,25,30,105
138452,1,3,7,17,22,27,34,111
138595,4,9,18,19,23,25,35,133
138734,1,3,9,13,22,26,33,107
138840,2,7,8,11,24,25,27,104
138925,3,4,15,18,19,25,34,118
139099,6,7,9,20,24,26,27,119
139183,6,7,9,14,25,29,31,121
139277,3,7,14,18,24,26,29,121
139283,7,10,11,13,22,26,31,120
139408,4,7,9,13,17,31,32,113
139457,2,7,9,11,21,26,27,103
139533,1,7,11,18,25,26,31,119
139857,1,5,16,17,22,25,30,116
139860,5,14,17,18,26,27,32,139
140226,4,8,9,17,25,31,33,127
140546,2,5,9,20,21,27,33,117
140799,2,5,16,19,22,31,35,130
140846,1,5,11,20,21,24,25,107
140877,1,5,11,16,22,29,32,116
140935,7,9,11,17,22,30,35,131
141153,1,4,7,16,22,27,31,108
141364,7,9,14,20,24,27,28,129
141623,4,14,17,18,23,26,29,131
141693,4,5,8,19,25,27,34,122
142045,3,7,14,18,22,28,31,123
142132,4,5,8,19,25,27,32,120
142141,2,10,11,13,17,26,27,106
142177,9,12,14,19,21,25,29,129
142240,1,6,9,13,24,30,31,114
142335,2,6,11,13,17,25,34,108
142336,2,4,8,13,21,24,29,101
142613,10,14,15,18,22,27,33,139
142621,3,5,9,16,21,29,30,113
143013,4,8,15,16,23,27,29,122
143494,6,10,11,14,21,25,27,114
143509,3,7,9,19,24,27,34,123
143936,5,9,11,16,21,28,35,125
144479,3,10,14,16,27,29,31,130
144642,4,6,9,13,26,31,32,121
144854,5,9,11,13,26,30,33,127
145261,1,5,7,18,26,29,35,121
145384,5,14,18,20,21,26,29,133
145435,1,10,18,20,24,27,33,133
145733,2,7,8,20,23,27,28,115
145791,5,14,16,20,23,29,30,137
145881,3,9,14,18,22,26,31,123
145947,6,10,15,16,19,25,29,120
146106,3,9,14,18,24,25,31,124
146119,3,6,15,20,23,26,27,120
146169,4,9,10,20,23,26,27,119
146378,5,9,16,19,22,24,33,128
146484,6,7,9,12,19,25,29,107
146599,2,7,8,24,29,30,33,133
146658,5,14,15,18,23,26,29,130
146893,8,9,17,20,24,26,27,131
147207,5,12,17,18,26,29,33,140
147326,7,14,17,18,23,26,35,140
147376,7,9,10,11,17,30,32,116
147489,3,7,10,14,23,27,29,113
147622,7,14,17,18,26,29,35,146
147627,2,5,9,17,23,24,35,115
147642,3,9,17,18,21,30,35,133
147704,1,4,8,13,23,27,29,105
147826,7,14,16,20,27,32,33,149
147831,1,7,16,20,25,26,28,123
147975,1,6,16,19,27,29,33,131
148007,2,4,8,13,23,25,29,104
148117,4,10,14,20,21,25,27,121
148153,10,14,17,18,19,27,33,138
148370,6,10,16,19,22,31,35,139
148414,2,7,8,12,27,28,29,113
148418,7,8,17,20,25,26,29,132
148974,2,5,11,17,21,25,30,111
149177,3,9,16,17,23,27,34,129
149258,2,8,9,12,19,24,35,109
149351,2,4,8,18,27,31,33,123
149383,4,8,17,20,23,29,32,133
149395,1,9,18,24,25,28,30,135
149422,7,14,15,18,22,24,33,133
149889,2,7,11,17,24,25,30,116
150621,7,9,10,13,19,24,31,113
150701,2,4,14,18,21,25,31,115
151262,1,7,11,12,24,27,34,116
151317,7,8,9,14,25,29,33,125
151493,2,8,11,18,22,29,33,123
151841,5,9,11,17,25,28,32,127
152082,2,5,9,18,24,26,33,117
152096,10,14,15,16,25,29,35,144
152135,1,3,9,18,21,24,25,101
152376,4,9,11,20,26,30,31,131
152409,7,9,14,20,26,27,30,133
152662,2,6,11,14,27,29,35,124
152728,1,8,16,19,22,25,29,120
153047,8,9,15,20,24,25,35,136
153282,7,8,15,24,26,29,30,139
153600,7,8,10,16,22,25,29,117
153643,4,8,9,20,25,27,33,126
153762,5,9,14,20,24,32,35,139
153808,2,8,17,18,24,29,33,131
153940,2,7,8,12,17,29,34,109
154070,7,8,16,18,23,25,29,126
154260,9,14,16,17,25,29,35,145
154454,3,6,9,16,19,29,33,115
154460,1,10,11,20,24,29,35,130
154725,9,12,18,20,21,25,28,133
154770,7,9,11,13,17,26,30,113
154861,9,14,16,20,21,24,31,135
154988,6,12,15,16,17,23,27,116
155044,1,6,7,18,25,29,31,117
155234,6,8,9,20,23,26,27,119
155701,2,8,11,14,29,31,35,130
155932,1,4,7,16,22,26,27,103
155984,3,14,17,18,24,29,33,138
156092,4,5,11,13,23,26,27,109
156292,2,4,8,18,21,25,31,109
156389,2,8,17,20,29,31,33,140
156415,7,8,11,12,22,28,35,123
156732,6,9,11,17,25,28,32,128
157072,2,4,8,13,24,27,31,109
157140,3,4,9,14,17,25,29,101
157213,1,7,16,17,22,26,29,118
157286,2,6,16,17,21,25,27,114
157295,3,7,15,20,21,24,34,124
157387,5,7,15,17,21,24,28,117
157428,2,6,7,17,26,27,33,118
157536,1,6,7,18,22,31,35,120
157735,6,7,14,20,23,25,27,122
157910,5,10,11,13,22,26,29,116
157925,5,7,11,19,22,26,31,121
158043,7,8,9,13,17,24,27,105
158064,4,5,7,11,19,27,32,105
158225,4,12,15,16,21,23,29,120
158295,2,7,14,20,23,24,29,119
158376,1,9,10,16,27,29,33,125
158636,6,8,9,17,21,29,35,125
158785,9,10,14,18,22,27,33,133
158810,1,4,16,20,23,29,31,124
158864,3,6,9,13,24,26,34,115
159035,1,12,16,18,23,25,29,124
159193,3,7,9,17,22,30,31,119
159360,5,7,17,18,22,23,30,122
159739,3,8,9,20,24,32,33,129
159827,2,5,9,11,26,32,35,120
159956,10,12,16,17,21,24,27,127
159984,3,4,10,18,21,24,25,105
160269,4,10,14,20,21,27,31,127
160344,4,8,15,20,27,29,35,138
160366,1,5,16,19,22,31,32,126
160378,5,9,11,12,21,24,25,107
160530,2,7,8,16,21,29,33,116
160552,3,4,7,17,21,27,28,107
160788,6,8,16,17,21,27,29,124
161204,3,9,16,17,27,31,34,137
161319,7,9,14,18,22,24,25,119
161392,3,9,16,20,21,28,31,128
161751,5,9,11,12,21,28,35,121
161843,2,7,8,20,27,29,31,124
161916,1,7,15,16,22,26,32,119
161931,1,4,7,18,29,30,34,123
162039,2,5,9,18,19,29,35,117
162062,1,4,9,18,19,25,29,105
162221,9,12,18,19,25,29,32,144
162354,6,7,9,13,21,29,30,115
162587,9,10,11,14,25,31,33,133
162745,1,7,11,19,22,26,35,121
162869,2,7,8,11,24,28,29,109
162967,3,10,17,20,24,26,35,135
162997,1,7,11,18,22,24,32,115
163116,1,9,16,19,22,26,28,121
163491,8,9,11,17,25,26,29,125
163561,3,9,17,18,21,25,34,127
163696,5,14,16,20,24,25,29,133
163996,9,12,18,20,21,29,33,142
164017,9,14,16,17,25,31,35,147
164377,2,7,8,14,26,29,33,119
164472,3,7,17,20,22,28,29,126
164484,9,10,15,16,19,26,29,124
164487,1,5,16,20,26,27,30,125
164611,2,5,9,11,25,26,29,107
164612,5,7,9,11,26,27,34,119
164770,1,5,11,20,21,29,30,117
164783,3,7,9,14,24,30,33,120
165000,3,7,11,13,26,27,32,119
165079,2,8,11,12,17,25,30,105
165135,4,9,15,18,19,23,32,120
165139,6,12,17,18,21,26,33,133
165144,1,7,18,20,21,29,33,129
165412,7,9,11,14,17,28,34,120
165450,6,9,11,13,26,30,32,127
165523,1,12,14,18,23,29,33,130
165655,9,12,14,17,25,29,35,141
165806,2,5,8,20,25,26,29,115
165953,8,12,14,20,21,29,33,137
166324,4,6,8,14,25,27,33,117
166484,7,10,14,18,21,24,29,123
166934,2,8,10,11,25,29,30,115
166959,8,9,15,19,26,29,35,141
167277,4,8,9,13,19,24,27,104
167283,3,12,18,20,25,26,29,133
167544,4,5,8,11,22,27,35,112
167621,5,8,11,24,25,27,31,131
167649,4,7,11,18,19,24,29,112
167662,3,4,15,19,24,25,35,125
167803,3,6,7,24,26,27,30,123
167867,4,6,9,17,19,25,29,109
167911,10,12,16,19,21,24,27,129
167973,7,9,11,18,19,24,32,120
167992,2,6,11,17,19,29,35,119
168140,1,7,8,11,22,30,34,113
168344,2,7,8,19,22,25,29,112
168367,1,4,14,20,21,24,25,109
168498,4,6,16,19,21,23,27,116
168719,3,8,9,13,25,29,34,121
168962,5,7,11,19,24,27,34,127
168978,1,10,16,20,29,30,35,141
169046,1,7,15,16,24,30,34,127
169682,3,4,14,20,23,27,32,123
169830,2,4,10,20,21,29,33,119
170208,3,4,8,18,19,29,35,116
170540,4,10,14,17,23,27,35,130
170825,1,7,15,19,22,27,32,123
170865,3,9,14,18,22,26,35,127
170893,2,8,11,13,23,27,31,115
171223,4,8,17,19,22,25,31,126
171240,4,10,14,18,23,25,33,127
171803,1,3,7,12,22,30,35,110
171840,3,9,11,18,19,24,28,112
172046,4,9,17,18,21,23,28,120
172066,4,5,14,18,27,29,33,130
172084,1,4,17,20,23,27,30,122
172241,10,12,16,19,22,23,27,129
172301,8,14,17,18,26,31,33,147
172324,5,7,8,11,27,30,32,120
172508,1,7,17,18,25,30,34,132
172702,7,8,9,20,22,26,29,121
173284,8,10,11,19,25,27,29,129
173410,5,8,15,18,24,29,33,132
173825,1,9,15,24,25,26,28,128
173867,1,7,17,20,21,24,35,125
174085,6,9,16,17,21,25,27,121
174263,4,5,10,18,19,25,29,110
174342,9,10,14,17,25,31,34,140
174346,5,9,15,20,21,24,35,129
174365,3,7,10,18,19,24,27,108
174565,2,8,9,18,22,29,33,121
174825,8,14,17,18,23,26,27,133
174878,2,4,10,14,25,27,29,111
174893,5,9,11,16,23,26,33,123
175046,4,10,16,17,23,26,27,123
175177,7,14,15,18,22,25,31,132
175200,1,9,18,19,22,28,29,126
175230,2,9,14,20,24,29,33,131
175417,2,10,11,14,19,25,34,115
175455,2,4,14,20,25,29,35,129
175624,4,9,10,11,17,31,35,117
175642,2,7,11,17,22,23,32,114
175655,7,8,11,14,27,28,31,126
175697,1,3,16,18,25,29,35,127
175768,1,9,17,18,24,28,34,131
175891,1,7,10,11,27,28,32,116
176051,6,14,17,20,25,26,29,137
176151,1,5,10,16,22,27,32,113
176411,4,7,10,16,21,25,27,110
176437,5,9,14,16,22,27,33,126
176534,1,5,7,12,22,29,35,111
177108,2,4,11,13,17,29,31,107
177132,1,4,10,18,23,27,31,114
177244,1,12,16,20,21,27,32,129
177296,1,4,17,18,21,24,31,116
177409,10,14,15,16,17,29,35,136
177680,6,12,15,16,21,25,29,124
177792,4,9,16,17,21,26,27,120
177909,1,7,11,18,24,27,34,122
177929,7,14,16,18,19,25,29,128
177991,1,7,9,18,24,25,29,113
178065,4,8,17,18,23,25,34,129
178076,2,3,11,13,17,26,35,107
178250,2,7,8,11,27,32,33,120
178285,7,8,10,12,22,23,29,111
178504,2,3,7,20,25,26,29,112
178559,4,8,11,17,23,25,27,115
178732,1,3,7,19,22,24,30,106
178773,9,12,17,18,22,23,27,128
178809,3,9,14,18,22,27,29,122
178924,9,14,15,18,24,30,33,143
178958,5,14,15,18,24,29,33,138
179072,2,8,10,11,21,25,34,111
179329,3,4,8,11,21,27,35,109
179487,1,9,16,20,22,24,35,127
179512,1,5,7,16,22,31,35,117
179561,5,14,17,18,24,32,33,143
179664,4,5,14,19,21,25,27,115
179877,4,8,15,19,23,24,25,118
179904,1,14,18,19,26,29,32,139
179991,1,3,7,20,24,29,30,114
180460,1,3,9,18,22,24,34,111
180658,1,4,8,20,23,28,29,113
180752,9,14,18,20,22,23,33,139
180999,1,6,18,20,23,29,33,130
181091,4,9,10,13,19,25,29,109
181141,8,10,17,20,26,31,35,147
181404,9,14,18,24,25,27,33,150
181475,1,5,10,16,24,27,34,117
181591,3,10,14,20,23,27,33,130
181672,7,8,11,16,17,27,35,121
181691,8,9,11,19,23,24,25,119
181732,7,9,11,14,17,25,32,115
182124,8,10,17,18,27,31,33,144
182260,2,4,17,19,29,31,35,137
182273,4,8,9,13,19,27,30,110
182290,1,5,11,20,25,28,33,123
182495,3,4,14,18,23,29,31,122
183095,2,6,9,20,21,27,32,117
183299,4,12,14,18,21,29,33,131
183548,9,14,15,18,24,25,27,132
183640,5,9,16,20,26,30,31,137
183718,9,14,16,18,27,29,35,148
183809,1,5,7,20,23,25,32,113
183968,2,8,18,19,29,30,33,139
184063,5,6,10,16,26,27,29,119
184131,7,14,15,18,24,29,33,140
184216,9,12,16,17,22,30,31,137
184387,7,8,15,16,19,23,29,117
184436,1,3,7,17,22,26,35,111
184458,1,3,7,12,22,24,35,104
184817,1,4,14,20,22,31,35,127
184936,1,7,9,13,22,27,34,113
185004,2,12,15,16,17,23,27,112
185260,2,7,8,11,26,29,34,117
185299,2,12,16,17,23,25,31,126
185375,2,9,17,20,26,30,31,135
185670,5,9,14,18,23,27,29,125
185798,3,9,14,20,26,29,30,131
185893,2,3,11,18,19,25,29,107
186027,6,7,8,17,23,27,30,118
186245,1,3,17,20,26,29,30,126
186716,1,6,7,11,22,31,35,113
186901,2,8,9,16,25,29,34,123
186952,4,5,16,17,21,27,29,119
187324,1,7,18,19,25,28,29,127
187447,4,5,11,16,21,23,27,107
187575,9,14,18,19,23,24,33,140
187663,4,6,16,19,22,27,31,125
187719,7,9,15,17,24,28,30,130
188040,4,10,15,19,22,25,31,126
188047,6,9,17,20,24,26,27,129
188258,3,5,17,20,24,27,33,129
188274,5,7,11,19,22,26,30,120
188621,7,9,11,12,17,28,31,115
188789,4,7,17,19,21,27,30,125
189181,1,5,11,16,22,24,29,108
189573,1,4,10,20,25,29,32,121
189609,3,7,15,17,24,27,30,123
189809,5,9,14,20,27,30,32,137
189814,1,4,7,20,22,24,29,107
189985,2,7,8,11,21,25,32,106
190085,1,9,15,18,22,23,32,120
190090,7,14,17,20,21,27,32,138
190653,2,4,7,11,17,28,31,100
190671,2,5,9,19,24,25,32,116
190721,9,12,14,18,22,31,33,139
190828,1,5,9,18,24,26,34,117
190984,6,8,16,18,25,29,31,133
190988,1,5,7,18,22,26,32,111
191059,8,9,16,19,23,24,29,128
191100,7,14,18,24,26,27,31,147
191121,3,10,11,13,17,27,34,115
191231,2,5,8,16,27,29,33,120
191261,5,9,14,20,24,29,31,132
191632,1,9,10,20,24,26,35,125
191653,9,14,15,20,26,29,33,146
191772,2,4,8,13,21,26,29,103
191848,4,8,17,20,26,29,35,139
192149,1,7,10,16,24,27,31,116
192388,2,10,16,17,26,27,31,129
192530,3,8,15,20,24,27,33,130
192537,3,8,11,20,24,26,27,119
192819,2,8,11,17,21,30,35,124
193008,1,6,11,16,22,26,27,109
193726,7,9,11,18,19,24,30,118
193858,3,6,11,18,21,23,27,109
194316,7,8,11,14,24,27,29,120
194786,1,5,11,16,27,30,35,125
194894,1,4,7,18,22,27,30,109
194930,1,3,7,18,22,28,34,113
195578,3,4,8,18,25,31,32,121
195855,9,10,14,24,25,29,35,146
196000,4,5,9,17,24,25,31,115
196003,2,14,16,19,23,29,33,136
196349,1,3,7,20,27,31,34,123
196754,7,9,11,17,22,32,34,132
196815,4,6,15,20,21,25,29,120
196867,1,6,16,17,23,27,31,121
196923,3,12,17,18,22,26,33,131
197232,2,6,9,13,23,26,29,108
197348,1,4,7,11,22,26,34,105
197435,1,7,9,17,19,26,30,109
197447,1,3,16,20,21,27,34,122
197530,2,7,14,20,25,29,31,128
197544,3,7,9,20,26,29,34,128
197548,1,14,16,18,22,23,25,119
197614,6,7,11,17,27,31,32,131
197740,1,5,9,18,23,29,30,115
197841,1,4,8,16,22,23,29,103
198318,1,5,7,20,24,31,34,122
198331,1,5,10,16,22,27,31,112
198557,4,6,17,20,21,25,27,120
198569,7,8,9,12,24,27,33,120
198886,2,6,7,14,23,29,30,111
198900,3,7,8,13,22,24,32,109
198920,5,9,11,18,19,24,27,113
198972,1,7,10,20,22,26,31,117
199934,3,7,11,18,19,25,30,113
199988,7,8,9,14,23,24,28,113
200089,4,5,16,17,23,26,27,118
200205,2,7,11,17,19,27,34,117
200224,5,8,9,13,19,24,27,105
200455,4,7,8,18,25,30,31,123
200568,4,9,15,20,26,31,35,140
200638,2,7,8,11,17,26,31,102
200645,2,7,9,24,26,29,30,127
200849,6,14,17,18,23,32,33,143
200894,5,9,11,14,26,27,35,127
200905,1,5,10,16,22,23,33,110
200913,1,8,9,18,23,24,27,110
201093,6,7,9,11,26,27,33,119
201103,4,7,16,17,23,27,32,126
201132,2,7,8,18,25,29,32,121
201390,1,9,14,16,25,29,31,125
201436,2,7,8,20,23,24,27,111
201446,1,6,7,20,24,27,31,116
201565,6,12,15,18,21,29,33,134
201736,3,6,9,14,24,31,35,122
201747,1,3,7,20,23,25,34,113
201757,5,9,11,19,25,30,34,133
202038,9,14,15,18,23,24,35,138
202058,2,4,11,13,17,23,33,103
202402,7,10,11,17,22,26,31,124
202414,4,14,18,20,25,31,35,147
202425,5,14,16,17,21,27,28,128
202439,1,8,9,13,24,27,30,112
202520,2,7,11,18,21,27,35,121
202621,4,10,17,24,27,28,35,145
203027,6,12,17,20,24,25,33,137
203032,2,6,11,13,17,29,30,108
203052,1,5,17,20,22,26,34,125
203414,2,5,17,18,27,31,33,133
203423,6,7,11,17,21,27,34,123
203455,5,8,11,18,22,27,33,124
203588,1,5,11,18,24,29,33,121
203824,3,7,16,19,22,27,31,125
203937,7,9,17,20,21,27,30,131
204091,4,7,8,18,19,24,27,107
204129,2,6,9,20,26,27,35,125
204457,9,14,15,16,24,27,31,136
204515,1,3,16,20,22,25,34,121
204726,5,8,9,14,23,25,29,113
204857,1,6,11,12,22,26,35,113
204971,3,7,8,18,23,24,34,117
205012,2,9,14,20,24,29,35,133
205026,9,10,16,20,21,23,27,126
205292,1,7,8,20,24,26,29,115
205732,2,5,7,11,22,26,29,102
205766,5,9,11,12,26,28,35,126
205892,5,7,9,14,22,24,28,109
206081,7,8,10,20,21,24,27,117
206112,5,8,11,16,25,27,29,121
206140,5,9,18,19,24,30,32,137
206193,2,10,14,16,21,27,29,119
206926,3,9,17,18,23,30,34,134
207032,3,4,10,18,19,23,25,102
207080,2,6,11,13,17,24,29,102
207103,7,9,14,16,27,29,33,135
207542,5,14,18,20,25,26,33,141
207760,2,9,14,16,22,25,29,117
207903,2,7,11,13,25,26,35,119
207925,5,9,11,14,25,29,30,123
208038,1,5,11,18,26,29,31,121
208072,1,4,7,13,22,26,30,103
208167,2,9,17,18,21,23,30,120
208202,7,8,14,20,27,31,32,139
208359,2,4,7,16,21,25,27,102
208566,7,8,11,19,22,24,28,119
208748,6,7,11,20,21,24,27,116
209097,2,8,16,20,21,27,35,129
209100,3,4,17,18,22,25,31,120
209284,2,6,8,11,17,23,35,102
209395,1,5,17,20,25,26,33,127
209776,2,6,9,13,19,29,35,113
209910,1,7,9,20,22,24,31,114
210209,5,14,15,19,26,29,35,143
210277,3,5,18,20,22,26,35,129
210294,9,12,16,17,29,30,35,148
210429,6,7,18,20,23,26,27,127
210811,3,7,14,16,22,31,35,128
211065,9,14,17,18,21,27,34,140
211112,2,10,11,13,17,26,35,114
211200,4,7,10,19,25,27,29,121
211207,4,10,14,19,22,31,35,135
211473,3,5,9,14,23,24,35,113
211588,1,4,8,14,25,27,28,107
211678,4,7,10,18,23,26,27,115
211862,7,8,11,14,24,27,28,119
211893,1,4,15,16,22,26,29,113
212067,1,3,16,20,21,27,35,123
212284,4,10,16,17,27,30,31,135
212347,4,9,14,18,24,25,35,129
212531,5,9,15,20,26,31,34,140
212914,4,7,17,20,23,24,31,126
212931,3,8,15,20,27,31,33,137
213441,4,7,9,13,26,27,34,120
213844,1,7,14,18,22,24,27,113
213858,9,14,18,20,21,25,32,139
214022,1,9,18,20,22,24,31,125
214223,3,9,11,16,17,28,32,116
214511,6,9,18,19,22,25,32,131
215179,1,5,15,20,24,26,27,118
215273,6,8,9,13,22,28,31,117
215364,3,6,11,16,17,23,27,103
215401,2,6,15,19,25,29,33,129
215562,1,3,7,13,22,27,34,107
215651,2,7,11,18,19,25,29,111
215921,2,7,8,11,26,29,35,118
216006,4,5,10,13,21,25,27,105
216059,1,12,14,18,22,23,33,123
216094,1,7,14,18,22,28,33,123
216311,7,14,16,20,25,28,29,139
216331,7,10,16,19,23,24,27,126
216334,4,12,15,16,19,25,27,118
216556,4,8,9,17,25,27,33,123
216750,3,7,8,18,24,28,29,117
216822,4,5,8,18,23,28,29,115
216942,1,3,7,17,26,27,28,109
217099,5,8,9,24,26,30,35,137
217199,3,7,11,20,22,26,27,116
217254,3,4,10,14,25,27,28,111
217446,10,14,17,20,26,29,31,147
217539,1,7,9,20,26,31,35,129
217678,7,8,11,17,22,23,33,121
217741,1,4,8,20,25,31,34,123
217805,3,5,9,16,24,26,33,116
218234,2,8,11,19,25,29,32,126
218253,3,9,14,20,29,31,35,141
218545,9,10,14,20,22,25,27,127
218557,4,5,9,14,25,28,31,116
218561,1,5,7,17,27,30,34,121
218594,3,9,14,16,29,31,35,137
218622,2,7,17,18,24,25,28,121
218632,3,8,16,17,21,27,29,121
218705,1,6,18,19,27,29,33,133
218875,7,8,9,12,17,29,35,117
218915,1,7,11,20,22,27,32,120
218931,5,9,14,24,25,30,34,141
218948,1,5,16,18,22,30,35,127
218955,2,4,7,19,23,29,31,115
218981,2,3,7,14,23,29,33,111
219085,3,4,14,18,25,29,35,128
219497,2,7,14,17,23,29,33,125
219603,2,8,11,19,22,26,35,123
219751,2,7,15,16,21,29,33,123
219794,1,14,15,19,22,25,33,129
220054,2,7,15,19,23,29,32,127
220101,2,4,8,18,25,29,35,121
220165,5,9,17,18,27,32,33,141
220228,4,5,11,18,21,23,25,107
220512,8,9,17,20,23,27,31,135
220589,3,5,7,11,22,26,31,105
220876,5,7,9,16,19,24,25,105
221130,3,7,17,18,25,30,31,131
221237,1,3,9,19,22,26,35,115
221276,3,7,18,19,24,27,31,129
221296,7,14,16,20,24,29,33,143
221348,4,5,8,20,21,23,29,110
221439,3,7,17,18,24,31,33,133
221538,4,8,17,18,24,25,27,123
221603,2,4,15,18,19,24,29,111
221646,1,4,17,20,22,26,35,125
221688,9,14,15,20,21,24,35,138
221735,1,5,11,20,26,29,31,123
222348,4,7,14,18,23,28,29,123
222412,2,4,14,18,19,25,29,111
222444,8,9,15,20,27,28,32,139
222560,4,9,14,17,23,25,29,121
222646,4,7,10,14,26,27,35,123
222722,3,6,9,13,24,26,29,110
222992,4,8,18,19,27,28,33,137
223106,5,7,10,11,21,26,27,107
223182,4,10,16,20,21,27,35,133
223202,8,9,16,20,21,27,34,135
223234,8,9,14,18,27,29,35,140
223272,4,7,8,19,21,27,35,121
223520,3,5,14,20,22,24,33,121
223601,1,4,11,13,17,27,34,107
223776,2,7,11,19,21,27,32,119
223818,3,12,15,16,21,28,29,124
224343,7,9,16,20,26,28,31,137
224785,1,4,8,19,25,27,29,113
224811,5,12,17,18,23,27,33,135
224939,5,9,17,18,22,28,29,128
225016,2,5,11,16,19,23,27,103
225120,4,14,15,16,27,29,33,138
225391,1,7,11,14,22,27,32,114
225670,1,5,11,20,25,31,32,125
225767,1,7,11,18,22,32,34,125
225779,4,8,16,19,27,29,33,136
225841,1,3,17,20,24,26,32,123
225888,1,5,9,20,23,29,32,119
226072,5,9,11,16,19,25,28,113
226135,7,8,9,18,24,28,31,125
226387,4,8,9,19,25,27,28,120
226405,9,12,17,18,23,27,29,135
226410,4,9,17,20,21,23,29,123
226429,2,5,7,24,25,26,30,119
226436,5,12,17,18,21,26,35,134
226489,5,7,9,11,26,28,34,120
226589,7,8,11,18,19,27,33,123
226699,5,8,9,18,21,24,29,114
226704,2,7,17,20,21,25,27,119
226712,3,9,14,16,17,31,35,125
226752,4,6,17,18,22,25,31,123
227021,3,6,17,20,26,29,33,134
227595,1,8,9,14,25,29,35,121
227977,4,14,15,18,25,31,34,141
227993,1,9,17,18,22,28,33,128
228165,2,6,16,19,25,29,30,127
228454,1,9,16,20,24,26,35,131
228491,3,14,17,18,25,26,32,135
228523,1,9,10,16,21,24,28,109
228597,7,9,11,19,22,23,28,119
228947,6,10,11,19,24,25,27,122
229327,7,9,15,18,22,26,27,124
229418,7,9,11,16,22,26,27,118
229446,3,4,17,18,19,23,28,112
229741,1,7,15,16,19,24,29,111
229785,9,14,16,17,21,27,33,137
229935,1,3,7,18,19,29,34,111
229965,2,8,11,12,25,28,33,119
230023,2,7,10,17,27,29,33,125
230108,4,5,9,20,23,26,27,114
230148,1,7,11,20,22,26,35,122
230272,4,12,15,16,21,29,35,132
230385,2,7,15,18,19,29,35,125
230449,1,7,11,12,22,24,31,108
230490,3,4,8,16,27,29,33,120
230541,5,7,17,18,21,24,35,127
230613,3,10,17,18,27,31,33,139
230651,4,10,15,16,19,24,29,117
230881,2,4,8,11,25,30,35,115
231036,10,12,16,20,21,27,33,139
231108,4,8,17,20,27,31,33,140
231161,3,4,15,18,19,28,34,121
231255,6,7,11,17,23,27,30,121
231509,2,6,16,19,25,29,33,130
231561,4,12,14,16,27,31,33,137
231619,7,10,15,16,19,29,31,127
231670,4,9,14,19,23,25,31,125
231756,1,9,14,20,23,27,30,124
231889,7,12,14,20,24,27,29,133
231997,3,6,9,16,19,23,29,105
232167,1,10,16,20,26,29,31,133
232174,1,5,16,18,24,25,31,120
232191,7,8,15,20,22,26,31,129
232200,9,12,17,24,25,29,31,147
232405,3,6,9,18,19,24,28,107
232511,2,5,9,16,21,24,30,107
232535,7,9,18,19,22,26,32,133
232565,2,6,7,11,19,25,32,102
232615,4,8,11,13,21,27,32,116
232865,4,10,17,18,21,26,35,131
232983,3,8,9,18,22,28,31,119
233034,3,7,18,19,29,32,35,143
233048,7,9,10,20,24,26,29,125
233091,5,14,15,16,22,27,31,130
233220,2,8,11,24,25,29,31,130
233228,7,10,11,18,21,27,32,126
233542,1,7,14,18,26,29,35,130
233627,1,6,10,20,26,29,35,127
234072,4,7,11,18,19,25,29,113
234195,4,6,10,13,26,27,33,119
234268,1,4,8,18,21,24,29,105
234297,7,14,16,24,27,30,31,149
234739,5,7,9,11,24,26,29,111
234888,6,7,8,12,22,27,29,111
234899,4,9,17,18,23,27,35,133
234930,4,12,14,18,19,27,31,125
235054,1,7,8,20,24,27,29,116
235065,5,6,9,11,21,28,35,115
235205,8,9,15,18,22,24,25,121
235352,10,12,15,16,21,24,25,123
235424,5,8,15,16,21,29,33,127
235498,9,10,14,18,29,31,35,146
235590,5,8,11,16,22,26,27,115
235642,1,4,8,19,22,25,33,112
235770,4,7,8,17,21,25,27,109
236146,1,10,16,20,21,27,31,126
236178,2,7,14,20,24,25,31,123
236300,8,9,10,19,25,29,34,134
236657,2,10,16,19,29,31,33,140
236861,2,6,17,18,23,28,33,127
237046,2,8,9,13,22,27,34,115
237106,2,6,16,17,19,25,29,114
237120,2,7,8,12,19,29,31,108
237156,8,9,10,20,23,27,29,126
237303,2,3,11,18,19,23,29,105
237735,4,10,11,13,21,27,31,117
237789,9,12,14,16,22,23,29,125
237883,9,10,11,13,17,25,30,115
237948,1,5,7,16,22,24,25,100
237970,1,5,16,18,24,29,34,127
238051,2,6,11,13,17,30,31,110
238089,5,9,17,19,24,25,34,133
238118,1,7,18,20,22,25,31,124
238175,1,9,16,20,22,30,35,133
238201,9,12,17,18,22,23,33,134
238222,6,12,16,17,25,27,28,131
238265,4,5,14,17,25,27,31,123
238387,2,8,16,19,23,29,31,128
238543,1,8,9,16,22,29,33,118
238723,3,5,7,14,22,28,29,108
238784,1,7,9,18,22,28,35,120
238876,1,6,7,20,27,31,33,125
239162,1,9,14,20,25,31,35,135
239166,7,9,11,19,26,28,32,132
239234,2,3,9,16,17,29,33,109
239277,4,9,15,16,19,31,35,129
239438,5,7,11,13,22,26,34,118
239502,1,9,15,24,25,30,34,138
239843,3,7,9,17,23,24,34,117
239870,1,10,11,14,17,27,35,115
240074,4,5,11,14,25,27,31,117
240129,4,8,18,19,21,23,29,122
240244,3,7,18,24,25,26,34,137
240285,6,9,11,14,19,25,29,113
240423,9,10,11,14,17,24,35,120
240451,3,10,15,16,19,29,31,123
240754,3,9,17,18,23,27,30,127
240791,5,6,11,18,21,23,25,109
241016,7,10,14,20,22,31,33,137
241020,1,9,15,16,22,26,29,118
241081,10,12,14,16,23,27,29,131
241143,10,12,16,20,21,29,33,141
241150,2,6,17,20,21,27,33,126
241161,1,5,16,20,22,28,35,127
241629,7,9,16,19,23,29,30,133
241649,9,12,17,20,21,24,30,133
241704,2,4,17,20,23,27,31,124
241720,9,14,16,18,22,25,27,131
242011,2,10,11,14,19,25,35,116
242024,4,7,10,13,17,27,30,108
242407,4,6,17,18,25,27,31,128
242447,2,4,11,20,21,25,27,110
242868,6,7,15,17,21,24,34,124
242887,3,7,9,11,19,30,34,113
242924,2,7,8,13,25,29,32,116
243082,4,5,14,20,27,31,35,136
243267,4,8,9,20,23,26,29,119
243329,1,9,15,20,26,30,35,136
243403,9,14,17,18,23,31,35,147
243609,9,12,18,19,26,29,30,143
243624,6,9,10,20,21,27,34,127
244080,1,9,16,18,22,27,32,125
244182,6,9,17,18,21,24,29,124
244225,5,14,16,18,24,25,35,137
244312,9,14,18,20,23,24,35,143
244341,2,6,7,12,17,24,33,101
244360,1,5,7,20,23,28,34,118
244431,1,5,16,20,22,26,29,119
244565,4,9,16,20,23,26,31,129
244577,5,7,18,19,22,24,30,125
244911,5,9,17,18,23,27,28,127
244973,7,14,18,20,25,31,34,149
244998,1,7,11,18,19,29,34,119
245038,2,6,11,12,21,25,30,107
245195,1,4,9,19,21,25,28,107
245278,3,9,16,17,23,24,27,119
245470,2,7,11,17,21,28,31,117
245580,1,4,7,18,29,32,33,124
245695,1,7,9,11,24,26,34,112
245808,1,8,9,13,24,30,35,120
245815,4,9,15,19,22,25,31,125
246020,4,7,14,18,19,25,28,115
246113,5,14,16,18,22,31,33,139
246346,8,12,16,17,27,32,33,145
246407,2,4,8,16,23,27,35,115
246593,8,9,10,14,25,29,31,126
246831,3,4,10,17,27,31,35,127
246915,6,7,11,12,21,27,31,115
247002,8,9,15,20,24,27,32,135
247008,1,7,11,12,23,27,34,115
247352,7,8,16,17,21,25,27,121
247558,1,5,11,20,24,25,34,120
247628,1,10,16,20,27,28,31,133
247915,4,6,18,19,23,29,30,129
247925,1,8,16,17,23,24,27,116
247944,8,9,15,18,26,29,30,135
248108,5,9,11,19,24,32,35,135
248251,9,12,14,18,23,26,29,131
248462,9,12,17,20,24,26,27,135
248475,9,14,18,19,24,27,31,142
248521,1,7,17,18,22,28,34,127
248548,2,4,8,14,19,25,31,103
248946,7,10,16,20,26,27,29,135
248983,6,9,15,19,24,25,30,128
249282,4,8,17,18,22,23,35,127
249322,2,5,11,16,17,25,29,105
249586,2,5,11,19,25,29,32,123
249848,5,10,16,20,26,27,31,135
249857,4,8,14,18,21,29,33,127
249988,1,6,18,24,29,32,33,143
250150,5,10,15,16,19,29,34,128
250182,7,14,16,20,22,31,33,143
250189,8,9,14,16,19,29,33,128
250791,2,7,15,19,25,29,34,131
250928,4,14,17,18,23,30,31,137
251071,3,8,9,12,25,28,29,114
251239,3,7,15,18,21,29,32,125
251514,5,7,11,18,21,28,34,124
251644,5,6,7,20,25,26,29,118
251661,4,5,17,20,22,26,31,125
251710,8,9,10,13,24,29,35,128
251806,3,8,16,18,22,23,35,125
252008,4,8,17,18,19,29,35,130
252012,2,5,11,20,21,25,33,117
252702,1,8,18,20,23,26,27,123
252735,4,8,9,16,21,25,31,114
252850,1,9,17,18,24,29,33,131
252898,4,5,11,13,22,26,35,116
253027,2,4,11,13,17,28,34,109
253232,3,6,16,17,21,27,32,122
253445,5,9,17,18,24,26,31,130
253461,4,8,17,19,22,25,29,124
253505,6,7,11,19,22,24,30,119
253546,5,7,8,19,22,25,29,115
253696,4,7,10,20,21,25,29,116
253729,8,14,15,16,19,27,29,128
254028,4,8,9,14,23,31,35,124
254073,4,9,11,13,19,27,34,117
254183,1,7,9,11,22,26,35,111
254299,6,9,11,13,17,24,33,113
254671,9,10,14,17,25,27,31,133
254689,2,7,11,14,19,25,32,110
254715,4,5,9,18,19,24,34,113
254841,3,7,8,17,23,27,32,117
254869,8,9,17,20,23,26,27,130
254884,7,8,9,13,17,24,33,111
255098,4,5,10,19,21,25,27,111
255480,10,12,18,19,27,29,33,148
255508,2,8,9,20,23,27,28,117
255728,8,14,17,18,21,26,31,135
255838,2,3,9,13,19,24,35,105
255879,1,5,14,16,22,27,33,118
255998,5,9,11,18,22,26,28,119
256099,5,12,16,20,21,26,29,129
256201,5,7,9,11,22,26,28,108
256243,1,7,15,16,19,29,34,121
256412,8,10,11,16,23,26,27,121
256548,7,9,11,19,24,25,34,129
256567,6,7,11,13,17,27,32,113
256589,7,14,15,19,23,29,34,141
256611,1,7,10,11,22,25,27,103
256643,1,5,15,20,26,29,35,131
256654,4,5,9,19,24,25,33,119
256830,10,12,16,17,22,29,33,139
256856,1,3,9,13,24,25,34,109
256987,7,9,11,13,17,26,28,111
257142,8,9,15,19,29,32,35,147
257150,4,12,14,18,25,29,33,135
257158,9,14,15,20,22,26,29,135
257159,3,7,14,24,27,28,33,136
257226,1,9,14,20,24,27,35,130
257429,4,8,11,13,19,27,33,115
257438,1,7,18,20,21,23,25,115
257533,1,8,9,24,25,30,34,131
257668,9,14,17,18,19,24,31,132
257748,9,10,17,24,25,28,34,147
257872,2,9,17,18,22,28,29,125
258208,2,6,11,17,25,29,31,121
258600,9,14,18,20,21,29,32,143
258715,2,7,11,14,23,28,34,119
258737,8,9,11,12,19,25,27,111
258779,2,7,9,18,19,25,29,109
259006,4,8,9,14,25,31,34,125
259112,2,6,15,16,19,23,29,110
259343,9,14,16,20,23,31,34,147
259530,1,4,7,12,25,27,31,107
259613,4,6,15,19,22,25,27,118
259964,4,6,14,18,19,25,27,113
260083,1,3,16,20,22,26,31,119
260233,5,10,17,18,19,23,33,125
260265,2,4,8,19,26,27,35,121
260446,1,4,7,18,19,23,34,106
261009,2,4,17,19,21,24,25,112
261081,1,7,15,24,25,26,30,128
261118,1,7,10,18,25,28,29,118
261153,1,4,17,20,21,23,30,116
261411,7,12,17,18,22,30,35,141
261502,2,8,11,13,17,25,32,108
261512,1,4,10,18,22,23,25,103
261649,1,14,16,20,23,29,34,137
261666,6,10,11,18,21,26,27,119
261670,2,12,16,17,22,29,33,131
262046,8,9,10,12,22,25,31,117
262078,2,8,15,16,24,27,31,123
262091,9,12,16,17,23,24,28,129
262102,7,8,17,20,21,26,31,130
262476,5,7,17,18,22,23,34,126
262665,7,14,17,20,21,23,27,129
262772,4,6,7,17,19,23,27,103
262784,5,7,18,19,22,24,31,126
262861,1,7,9,16,26,29,33,121
263106,7,8,11,19,21,27,32,125
263165,3,4,7,12,26,27,32,111
263216,3,7,11,19,22,25,32,119
263502,3,4,14,18,25,30,31,125
263599,1,7,16,19,22,23,32,120
263770,3,8,9,13,24,30,35,122
263887,5,9,14,24,27,30,35,144
263916,7,10,17,18,25,31,35,143
264093,1,14,16,20,21,23,34,129
264124,2,7,8,11,17,28,32,105
264184,7,10,14,20,25,30,31,137
264319,4,12,18,20,21,25,27,127
264449,3,8,9,19,25,26,29,119
264461,2,9,11,16,22,26,31,117
264656,5,12,14,16,22,29,31,129
264768,4,14,18,20,25,27,33,141
264807,10,12,14,24,25,27,33,145
264828,7,8,9,14,24,31,35,128
264859,1,4,7,14,19,27,31,103
264894,4,8,9,11,25,28,31,116
265027,9,14,17,20,24,26,31,141
265032,1,4,17,20,24,27,33,126
265160,1,6,7,18,22,27,30,111
265166,2,4,8,13,27,29,31,114
265213,5,7,9,18,22,26,28,115
265393,4,8,10,14,25,27,31,119
265400,7,8,15,18,23,29,33,133
265445,6,14,15,20,26,29,33,143
265454,8,10,11,16,23,27,35,130
265512,9,10,16,20,21,24,31,131
265762,2,8,9,13,23,26,29,110
266013,4,6,10,16,19,27,33,115
266335,4,10,15,19,21,29,35,133
266370,4,10,11,13,19,27,31,115
266476,3,14,16,17,21,27,32,130
266479,3,8,16,18,23,25,29,122
266482,2,6,16,19,29,30,35,137
266673,3,7,16,20,26,27,29,128
266878,2,6,17,18,25,31,33,132
267046,6,14,16,18,21,29,35,139
267198,1,6,16,18,24,25,29,119
267401,7,14,15,24,27,28,34,149
267412,4,5,10,17,25,27,31,119
267761,1,10,16,20,25,28,33,133
267828,7,10,14,20,27,30,35,143
267934,6,7,14,20,23,27,34,131
268037,3,7,11,17,22,27,32,119
268191,5,9,15,19,24,32,35,139
268318,9,14,16,24,25,29,30,147
268360,2,4,15,18,19,23,25,106
268387,4,12,15,16,21,23,27,118
268595,7,10,11,14,21,27,29,119
268812,1,7,9,24,26,30,33,130
268848,1,7,16,20,24,25,31,124
269184,7,9,11,16,17,26,29,115
269244,7,8,9,13,24,29,33,123
269315,3,7,11,12,21,27,34,115
269527,1,5,11,18,22,30,32,119
269662,2,7,9,13,17,29,34,111
269795,5,9,11,16,17,29,30,117
269808,3,7,14,17,26,27,32,126
270154,1,5,7,18,27,28,29,115
270242,5,9,14,16,22,24,25,115
270261,2,3,15,20,26,29,30,125
270288,2,6,7,17,19,23,29,103
270357,3,8,16,19,22,27,31,126
270420,2,8,11,20,25,29,35,130
270675,7,14,18,20,27,30,33,149
270800,3,7,9,20,26,31,34,130
271395,1,7,14,20,21,29,33,125
271460,2,3,7,14,23,25,29,103
271561,3,7,17,18,22,24,30,121
271902,9,12,17,18,21,32,35,144
272028,1,4,14,18,29,30,35,131
272132,1,12,18,19,25,29,33,137
272248,8,12,17,18,26,27,29,137
272261,1,5,14,20,23,25,33,121
272289,4,6,17,20,23,25,27,122
272312,4,12,14,19,25,27,31,132
272372,1,7,16,17,21,27,32,121
272562,1,9,17,18,23,24,28,120
272665,1,5,11,20,27,30,34,128
272720,1,9,16,17,21,26,27,117
272894,5,7,11,20,26,29,35,133
273040,2,10,11,14,25,29,31,122
273100,3,8,9,20,21,31,35,127
273392,5,9,18,19,24,28,35,138
273433,2,6,10,17,25,27,33,120
273454,8,9,17,18,23,25,29,129
273692,4,5,8,18,21,29,35,120
273807,9,10,17,20,23,26,27,132
273857,4,8,10,20,21,27,31,121
274117,4,9,11,13,19,24,29,109
274132,7,8,15,17,21,31,34,133
274246,3,5,7,20,21,27,32,115
274348,3,12,18,24,26,27,31,141
274432,5,9,14,18,22,24,25,117
274578,7,12,15,16,19,25,29,123
274690,5,9,14,20,21,29,34,132
274691,5,8,9,13,19,28,29,111
274765,2,7,8,18,25,26,29,115
274846,5,7,14,20,23,27,34,130
275136,2,7,14,20,25,27,29,124
275208,3,4,8,20,23,29,31,118
275257,9,12,17,20,24,26,33,141
275292,3,9,11,20,21,24,30,118
275411,5,9,14,20,23,24,30,125
275456,7,12,16,20,21,24,27,127
275617,8,14,17,18,27,30,33,147
275720,6,8,11,18,29,31,35,138
275851,4,7,11,14,19,25,27,107
275920,1,9,15,20,24,28,33,130
276062,3,7,16,19,22,29,31,127
276210,3,9,16,20,22,26,29,125
276503,1,4,8,14,27,31,35,120
276551,5,9,15,18,22,26,35,130
276636,1,5,7,18,29,30,35,125
276644,1,3,7,20,24,25,28,108
276656,9,12,16,18,19,29,33,136
276724,2,5,14,20,24,29,33,127
276789,2,8,11,18,24,29,33,125
277060,4,12,14,20,21,25,27,123
277073,7,9,11,12,17,28,29,113
277102,6,7,11,19,21,27,30,121
277477,5,9,16,18,21,29,35,133
277549,5,7,9,11,21,24,34,111
277665,7,14,16,18,26,29,35,145
277756,2,10,11,17,25,31,35,131
277926,1,12,14,16,17,27,33,120
277941,1,8,10,16,22,29,33,119
277953,3,6,9,20,22,26,29,115
277962,7,9,14,20,22,24,35,131
278023,8,14,17,18,23,25,33,138
278054,6,8,11,18,24,27,31,125
278432,7,9,14,20,24,27,35,136
278489,1,4,17,18,21,29,35,125
278552,4,6,17,18,21,27,34,127
278686,2,6,7,17,27,28,34,121
278792,3,9,11,13,21,28,34,119
278846,1,5,7,20,22,23,28,106
278954,5,9,11,18,21,28,31,123
279017,3,7,11,16,17,27,34,115
279217,2,8,11,13,17,30,34,115
279549,3,10,14,16,26,27,29,125
279680,1,3,7,18,25,26,29,109
279971,2,7,9,11,21,27,34,111
280054,4,14,15,18,23,28,29,131
280130,1,5,11,20,25,30,31,123
280628,7,8,11,14,26,27,32,125
280650,1,3,7,13,22,28,33,107
280928,5,7,15,18,19,24,27,115
281321,2,7,11,14,19,25,28,106
281333,2,8,9,13,23,29,32,116
281372,9,10,18,19,23,24,32,135
281586,6,9,10,13,19,24,28,109
281773,1,7,11,18,19,32,34,122
282030,3,7,18,20,22,26,31,127
282126,8,9,17,18,23,28,32,135
282141,8,14,15,18,25,26,29,135
282209,3,5,11,16,26,27,30,118
282245,4,8,10,18,19,25,35,119
282331,6,7,17,18,19,23,31,121
282346,7,10,17,18,22,28,35,137
282580,4,12,17,18,19,23,30,123
282711,1,5,9,20,26,27,31,119
282782,7,8,10,11,21,27,29,113
282832,9,10,16,20,26,29,35,145
282979,2,4,7,11,21,27,28,100
283193,7,8,10,13,22,26,31,117
283263,4,6,9,13,19,24,32,107
283316,1,3,16,24,27,31,33,135
283837,1,7,8,20,22,27,31,116
284019,4,7,10,16,17,27,31,112
284190,1,4,18,19,24,29,33,128
284438,4,5,9,11,21,25,34,109
284564,5,7,10,20,21,25,27,115
284624,4,14,18,19,25,28,31,139
285000,2,6,11,16,17,27,32,111
285279,7,8,9,13,24,25,27,113
285410,4,6,17,18,21,23,25,114
285490,5,9,11,17,22,25,28,117
285669,7,12,17,18,21,28,34,137
285776,8,9,15,20,24,27,29,132
286159,3,7,10,16,17,25,27,105
286251,5,9,15,16,21,24,27,117
286500,2,9,15,18,19,29,34,126
286541,4,8,9,16,29,31,35,132
286652,2,4,9,13,21,23,29,101
286705,5,12,14,16,22,23,31,123
286767,1,10,17,18,21,23,33,123
286815,9,14,18,20,21,28,29,139
286972,1,9,15,17,25,28,32,127
287320,6,7,8,11,22,28,31,113
287729,5,8,16,20,26,27,31,133
288002,2,10,11,20,21,25,27,116
288095,1,9,14,24,25,28,30,131
288280,3,9,14,18,22,31,32,129
288309,1,4,7,18,26,29,33,118
288401,1,5,11,20,21,27,30,115
288534,4,6,10,18,19,25,31,113
288543,1,5,16,17,23,27,32,121
288862,3,7,9,14,19,24,34,110
288960,1,14,18,20,25,28,33,139
289132,4,7,9,18,21,24,25,108
289249,3,7,16,19,22,28,29,124
289752,9,10,14,17,25,29,35,139
289832,1,4,11,18,22,25,31,112
290035,2,14,15,18,23,29,33,134
290065,5,9,14,20,22,23,29,122
290118,2,3,8,20,24,29,33,119
290504,3,6,9,14,21,24,25,102
290533,3,7,14,20,21,29,30,124
290659,1,7,8,12,22,25,32,107
290849,4,8,9,18,19,25,29,112
290964,5,9,15,16,26,29,33,133
291166,1,9,14,18,24,28,29,123
291265,1,6,16,18,27,29,33,130
291349,7,14,18,19,21,24,27,130
291419,1,4,7,18,21,25,30,106
291737,1,7,9,11,22,23,32,105
291860,7,8,17,20,23,27,34,136
292056,3,14,17,20,21,26,31,132
292146,4,6,17,18,24,29,33,131
292316,3,9,10,20,21,24,31,118
292336,5,8,9,16,17,29,35,119
292391,8,9,16,17,23,27,30,130
292499,1,5,10,11,22,31,35,115
293213,5,7,8,17,23,27,28,115
293338,1,7,11,19,22,32,34,126
293465,2,9,16,17,22,26,29,121
293605,1,3,7,20,21,23,34,109
293661,8,9,18,20,24,25,35,139
293690,4,10,15,17,24,25,29,124
293828,8,9,15,20,23,24,33,132
293922,6,9,10,16,17,28,29,115
294075,2,9,16,18,21,24,25,115
294329,2,9,16,19,22,31,35,134
294333,2,5,9,16,17,25,31,105
294483,3,8,9,24,25,29,32,130
294739,1,6,18,19,22,25,33,124
294833,2,9,15,20,24,26,27,123
294845,8,9,10,13,17,23,29,109
295080,2,7,11,16,26,29,32,123
295153,2,3,9,19,25,28,29,115
295160,1,7,15,19,22,24,25,113
295730,8,9,16,17,23,24,28,125
295848,5,8,10,18,22,27,33,123
295882,4,8,9,18,21,27,32,119
295938,2,4,16,19,25,26,29,121
295948,5,9,11,16,24,26,32,123
296183,7,8,11,17,22,26,30,121
296215,6,8,11,20,25,29,31,130
296324,1,7,8,18,22,29,33,118
296349,5,7,17,20,24,26,29,128
296902,6,10,16,18,19,25,29,123
296973,1,10,16,18,22,31,33,131
297120,4,6,14,20,21,29,33,127
297450,3,5,9,20,21,24,25,107
297714,4,6,14,20,23,27,33,127
297880,2,4,11,17,25,27,31,117
298320,6,12,16,17,24,27,29,131
298541,6,12,17,18,29,31,33,146
298616,3,8,11,13,17,27,28,107
298636,4,7,8,13,21,27,30,110
298647,1,7,9,12,24,25,28,106
298856,10,14,16,20,23,27,31,141
298912,3,4,7,18,21,25,31,109
298952,5,7,11,16,19,27,34,119
298960,3,8,11,16,25,27,31,121
299067,4,8,11,20,22,25,31,121
299123,1,4,15,24,25,29,31,129
299182,2,14,15,18,24,25,33,131
299261,1,4,15,16,21,23,27,107
299323,1,9,11,18,22,24,29,114
299325,5,9,14,16,23,24,30,121
299338,4,14,17,20,24,29,33,141
299362,9,14,16,20,23,24,35,141
299426,6,9,15,18,22,26,33,129
299528,1,5,16,20,22,23,33,120
299772,3,8,18,19,25,29,33,135
299777,1,9,14,20,23,26,30,123
300012,7,8,10,18,22,29,35,129
300385,1,3,9,13,22,30,34,112
300442,3,4,14,18,23,24,27,113
300484,2,7,9,11,22,26,28,105
300562,5,9,14,16,22,31,33,130
300573,4,12,17,24,25,27,31,140
300654,2,9,15,17,25,29,32,129
300686,1,6,16,19,22,26,35,125
300975,3,7,14,20,29,32,35,140
300981,1,4,7,14,27,30,31,114
301224,1,7,9,20,26,30,35,128
301273,7,8,10,14,17,23,27,106
301382,1,7,17,20,26,30,32,133
301383,4,7,9,13,19,24,27,103
301792,7,12,14,20,27,31,32,143
301967,4,10,11,20,21,25,32,123
301974,9,10,16,20,21,31,32,139
301979,1,4,7,20,25,28,32,117
302213,3,7,8,14,17,25,27,101
302238,2,4,10,14,25,27,33,115
302490,3,8,9,12,23,25,29,109
302621,1,7,16,20,24,27,34,129
302816,6,7,17,18,21,27,30,126
302872,9,10,14,20,23,31,33,140
302883,4,9,11,13,19,30,35,121
302928,1,7,17,20,22,24,31,122
302969,3,10,14,16,27,29,30,129
303214,7,8,11,14,27,30,35,132
303225,1,7,8,17,22,26,34,115
303375,1,7,17,20,26,30,35,136
303654,9,10,14,16,27,29,30,135
303851,2,8,18,20,29,31,33,141
304143,2,8,17,18,21,26,29,121
304246,8,14,17,18,21,29,33,140
304276,9,12,17,18,22,28,33,139
304319,3,10,11,14,21,25,27,111
304336,4,8,16,17,21,27,31,124
304337,1,8,15,20,23,29,33,129
304386,7,9,10,11,17,24,33,111
304486,5,8,9,20,22,29,35,128
304589,4,7,17,24,26,27,30,135
304754,6,9,16,19,23,29,32,134
305455,8,9,17,20,23,24,31,132
305486,9,10,14,19,27,29,35,143
305565,1,5,9,20,22,29,35,121
305717,7,8,17,20,23,27,29,131
305803,3,8,9,20,24,31,34,129
305913,3,6,9,13,21,24,32,108
305979,3,10,17,20,26,31,35,142
306034,10,14,15,16,22,25,27,129
306147,4,5,14,18,25,31,32,129
306414,1,5,7,13,22,24,34,106
306959,3,9,17,20,24,27,31,131
307326,7,8,9,14,27,29,31,125
307348,1,12,18,19,22,24,33,129
307354,7,10,11,18,19,23,29,117
307411,9,10,11,16,21,29,33,129
307488,1,4,15,24,25,26,30,125
307613,9,10,11,16,19,23,32,120
307697,3,8,10,18,24,29,33,125
307838,7,10,16,17,22,31,35,138
307846,2,6,7,12,25,26,29,107
308258,5,8,10,13,27,29,33,125
308264,1,9,18,19,23,24,34,128
308481,5,8,9,18,22,28,35,125
308538,1,5,16,17,22,24,27,112
308577,4,7,8,14,19,27,34,113
308604,4,5,8,19,22,24,25,107
308605,1,4,8,24,25,27,33,122
308611,4,8,15,16,17,25,31,116
308797,4,8,9,20,26,31,33,131
309223,8,12,17,18,22,27,33,137
309272,4,7,14,18,26,29,35,133
309338,4,8,15,18,24,27,35,131
309370,1,5,15,16,22,30,32,121
309421,4,9,18,19,22,24,35,131
309496,4,8,9,18,19,25,32,115
309551,1,7,18,19,22,26,27,120
309634,7,9,17,18,26,30,32,139
309750,5,7,16,20,21,23,29,121
310009,1,5,11,18,22,31,35,123
310150,5,9,14,17,22,29,35,131
310442,10,12,16,17,22,29,35,141
310443,3,7,9,14,27,29,32,121
310793,1,5,17,18,26,29,32,128
311291,2,8,17,18,21,26,35,127
311426,6,7,8,11,17,27,33,109
311816,5,14,16,20,22,25,31,133
311818,10,12,17,18,22,25,33,137
311951,3,4,8,13,21,27,34,110
312222,2,4,9,17,23,25,27,107
312419,5,9,11,20,21,31,32,129
312425,7,9,17,19,24,30,34,140
312765,3,4,17,18,23,27,33,125
312776,7,9,10,19,22,24,28,119
312972,4,6,15,16,21,24,25,111
312989,1,5,10,24,25,27,33,125
313443,1,9,18,20,29,31,35,143
313622,1,7,11,20,22,26,27,114
313682,3,7,17,18,24,26,33,128
314348,5,9,16,20,26,27,29,132
314512,1,4,15,17,21,25,30,113
314565,1,8,16,17,21,27,31,121
314627,1,9,16,18,22,29,33,128
314883,9,12,16,18,19,29,32,135
314924,4,7,15,17,24,30,34,131
314977,5,8,18,20,24,29,33,137
315130,6,7,9,17,21,24,27,111
315150,2,5,10,16,21,25,29,108
315291,2,4,11,17,21,23,35,113
315310,8,9,15,20,27,31,32,142
315344,1,5,9,18,26,29,32,120
315345,7,12,18,19,25,29,35,145
315437,4,9,11,13,17,26,31,111
315542,1,5,11,14,25,27,30,113
315759,6,8,16,19,22,25,29,125
316252,1,5,11,18,22,26,35,118
316257,2,7,11,12,21,23,29,105
316354,2,10,18,19,23,29,33,134
316567,5,8,9,11,19,28,35,115
316651,4,7,9,13,21,28,29,111
316809,3,4,15,20,21,24,34,121
316917,7,14,17,20,27,28,31,144
317035,6,9,17,18,21,23,31,125
317201,4,9,11,20,26,29,33,132
317284,2,6,11,14,19,24,25,101
317586,2,3,7,17,23,24,32,108
317597,1,7,11,20,25,30,35,129
317622,3,8,9,13,24,26,34,117
317755,3,6,9,14,29,31,35,127
317829,1,6,7,20,21,25,32,112
318398,3,6,14,20,24,25,33,125
318703,2,5,9,20,21,24,30,111
318770,1,3,9,20,22,26,33,114
318771,6,9,10,17,22,25,31,120
319023,4,6,16,17,27,31,33,134
319076,7,8,14,19,25,27,29,129
319078,1,6,8,16,22,31,35,119
319700,5,9,11,16,24,26,33,124
319765,6,7,10,20,21,27,28,119
319855,7,8,11,14,22,29,30,121
320001,7,10,16,17,22,29,33,134
320708,1,7,14,20,22,27,31,122
320777,6,7,17,18,24,29,33,134
320826,9,12,17,20,22,23,27,130
320832,5,6,16,20,23,26,27,123
320911,2,10,11,13,17,27,34,114
321112,4,10,17,20,24,31,33,139
321133,5,6,14,20,29,30,33,137
321179,2,4,9,16,19,23,29,102
321333,3,7,16,20,26,31,34,137
321445,7,10,11,13,21,24,27,113
321460,4,9,10,13,21,30,31,118
321597,2,6,9,12,19,25,29,102
321838,5,6,16,18,19,23,29,116
321881,2,8,11,24,25,27,29,126
322001,7,10,11,13,21,27,32,121
322370,2,6,10,16,17,25,27,103
322664,5,6,7,17,23,27,34,119
323073,1,4,14,18,24,29,31,121
323240,5,7,11,19,22,25,28,117
323768,2,7,18,20,25,26,29,127
323939,4,6,18,19,27,31,33,138
324644,1,7,15,20,23,27,28,121
324734,5,6,10,11,26,27,35,120
324745,1,3,9,14,22,25,29,103
324771,7,10,17,20,21,25,31,131
325058,10,14,17,18,23,26,31,139
325079,2,5,17,18,19,23,33,117
325459,6,9,17,20,24,30,31,137
325499,4,7,17,24,27,30,31,140
325557,6,9,16,20,26,27,35,139
325643,1,10,14,16,22,25,31,119
325678,1,7,10,17,22,26,35,118
325960,1,3,15,18,22,27,33,119
326132,8,9,15,18,22,25,34,131
326511,4,8,14,17,23,27,35,128
326519,1,4,8,20,21,27,31,112
326588,3,4,16,19,27,31,33,133
326698,4,7,8,13,22,27,32,113
326709,1,7,18,20,22,23,27,118
326925,5,6,7,11,22,26,35,112
327219,5,6,7,12,22,26,31,109
327395,5,8,11,16,21,25,27,113
327475,2,8,9,13,17,24,30,103
327500,7,8,9,11,17,24,31,107
327612,5,9,16,19,22,27,30,128
328166,2,3,16,17,21,24,27,110
328274,2,8,11,20,26,29,33,129
328374,8,9,14,20,22,23,27,123
328419,2,4,17,18,21,27,28,117
328432,2,9,14,24,25,29,31,134
328435,7,14,15,19,23,28,29,135
328648,10,14,16,17,23,27,35,142
328750,2,7,9,11,17,26,33,105
328757,3,8,17,20,23,26,27,124
328793,10,12,15,16,17,24,29,123
328809,2,8,15,24,25,29,33,136
328885,1,9,11,18,26,30,32,127
328946,7,10,11,19,25,27,34,133
329064,2,7,11,17,26,27,30,120
329114,7,10,11,17,22,31,34,132
329126,7,9,11,13,17,28,30,115
329181,3,4,7,19,21,27,28,109
329322,4,7,11,13,24,26,27,112
329442,2,6,9,19,25,28,29,118
329472,3,4,14,20,27,31,35,134
329481,1,3,9,13,24,28,31,109
329570,5,7,10,20,25,26,29,122
329707,1,5,11,16,23,24,27,107
330077,3,8,11,13,17,24,27,103
330247,2,6,11,14,17,23,35,108
330292,2,7,9,11,17,29,34,109
330552,5,10,18,19,23,29,33,137
330862,7,8,17,20,25,27,31,135
330937,6,9,11,12,26,30,35,129
331018,3,7,10,20,26,31,34,131
331065,3,4,15,20,21,27,31,121
331072,4,9,16,18,19,25,29,120
331131,3,7,16,18,26,29,32,131
331297,1,9,14,20,24,30,31,129
331383,3,4,17,20,24,30,31,129
331600,2,6,10,16,17,29,33,113
331668,1,5,7,20,26,29,32,120
332061,2,9,17,20,23,27,28,126
332115,8,9,11,19,22,25,29,123
332188,4,5,14,20,24,25,33,125
332313,5,7,8,11,22,25,27,105
332333,2,4,11,13,17,24,31,102
332356,2,3,11,20,22,26,27,111
332394,1,3,18,24,26,27,30,129
332448,1,9,10,20,27,29,33,129
332719,3,9,17,18,22,28,30,127
332902,1,5,14,20,26,29,31,126
332951,7,10,16,17,21,27,33,131
332988,7,10,14,17,23,27,29,127
333223,5,9,10,18,21,24,35,122
333235,2,8,9,13,24,27,33,116
333248,1,12,15,20,22,26,29,125
333554,1,7,16,18,27,29,31,129
333622,3,14,16,17,22,25,29,126
333636,3,9,17,20,24,25,33,131
333784,4,5,14,16,23,27,33,122
334031,3,4,10,13,17,27,28,102
334260,1,4,14,20,21,25,34,119
334296,8,9,15,20,22,24,31,129
334357,4,9,11,14,23,25,29,115
334572,2,7,8,13,17,24,30,101
334750,6,9,11,13,17,28,35,119
334946,6,9,11,13,19,28,34,120
335063,1,3,7,18,22,24,27,102
335504,2,8,11,18,22,31,33,125
335521,5,9,11,18,21,28,32,124
335522,4,10,15,19,25,31,33,137
335642,3,6,16,20,21,26,29,121
336036,2,8,18,19,26,29,33,135
336190,1,4,9,13,19,28,35,109
336294,5,7,8,11,27,28,30,116
336435,2,7,11,13,17,32,35,117
336476,8,9,14,17,24,28,35,135
336502,9,14,15,19,24,25,29,135
336594,2,6,11,13,19,24,29,104
336813,6,10,17,20,26,27,33,139
336867,7,14,16,20,26,27,31,141
337004,1,10,14,16,22,23,29,115
337066,2,6,11,13,17,25,35,109
337240,1,7,8,11,22,29,35,113
337287,9,14,15,17,19,24,25,123
337435,2,4,8,20,29,31,33,127
337466,4,8,10,13,21,27,31,114
337516,4,9,11,13,17,28,32,114
337664,3,9,17,18,19,23,32,121
337685,3,5,17,18,22,26,32,123
337745,4,9,11,13,17,23,32,109
337758,8,10,17,20,21,26,27,129
337981,2,5,9,16,17,29,35,113
338172,7,12,14,18,26,27,29,133
338381,4,8,10,24,25,27,29,127
338500,4,14,18,20,23,27,33,139
338729,4,8,9,13,19,24,28,105
338740,1,3,10,16,24,27,28,109
339000,7,14,16,20,21,29,30,137
339015,5,7,11,16,26,27,31,123
339113,9,12,16,17,23,29,34,140
339183,4,6,7,19,23,27,29,115
339238,5,9,10,16,19,24,30,113
339401,3,7,9,18,19,26,29,111
339718,4,6,10,13,17,27,34,111
339762,2,3,9,16,19,24,28,101
339841,1,4,9,24,29,31,35,133
339875,1,10,16,20,23,25,28,123
340017,4,8,9,12,24,29,35,121
340205,2,9,11,14,19,23,25,103
340525,4,9,17,20,24,26,31,131
340695,1,10,11,20,29,31,35,137
340751,4,8,9,17,19,25,29,111
340805,8,10,11,13,17,27,29,115
340893,5,8,9,11,22,23,35,113
341075,2,5,16,20,21,27,29,120
341136,1,7,16,19,24,27,31,125
341147,1,7,10,14,24,26,27,109
341208,4,7,11,20,26,27,32,127
341354,3,5,16,20,21,27,33,125
341359,1,7,8,19,24,27,31,117
341469,4,7,8,14,27,29,33,122
341496,9,10,17,24,25,30,34,149
341508,4,9,17,20,22,23,27,122
341781,2,6,9,19,23,25,29,113
341874,1,4,11,16,22,26,29,109
341953,3,4,7,14,26,27,32,113
342001,6,9,14,20,24,25,33,131
342155,5,9,10,13,19,24,25,105
342215,1,6,16,17,21,24,27,112
342251,7,10,11,17,22,26,32,125
342276,7,8,11,14,25,27,35,127
342329,9,12,17,18,19,30,34,139
343024,1,7,10,11,22,28,33,112
343044,3,10,16,17,22,26,29,123
343168,1,7,9,24,26,27,28,122
343287,2,9,17,18,21,27,32,126
343614,7,9,11,16,21,24,30,118
343637,4,9,10,14,21,24,25,107
344733,3,8,9,20,22,24,31,117
344768,4,10,18,19,21,25,27,124
344859,1,9,16,20,23,25,31,125
344955,8,9,16,19,25,29,35,141
344968,7,8,9,14,25,29,32,124
345155,7,8,18,19,21,23,29,125
345330,4,7,10,12,23,26,27,109
345399,1,9,10,19,25,29,32,125
345415,1,8,9,20,25,29,35,127
345463,3,8,9,20,24,26,31,121
345768,5,10,15,20,26,29,30,135
345881,3,12,16,20,25,26,31,133
346159,3,5,18,19,22,28,33,128
346233,1,7,10,11,25,26,27,107
346353,4,14,15,16,27,31,33,140
346431,2,3,16,17,21,26,27,112
346598,2,7,11,17,23,30,34,124
346716,5,7,11,12,17,27,28,107
346827,7,9,11,16,17,27,28,115
346944,1,6,7,19,22,23,29,107
346988,5,9,10,18,24,26,31,123
347061,1,7,10,20,21,25,35,119
347540,4,9,10,14,25,28,29,119
347704,1,8,11,12,22,29,35,118
347975,3,7,9,17,26,27,32,121
348009,8,14,15,16,17,25,29,124
348165,2,3,7,13,22,26,29,102
348224,1,7,17,18,24,28,35,130
348244,2,9,15,19,22,27,35,129
348329,7,12,17,18,22,23,28,127
348492,3,12,15,16,17,24,30,117
348530,7,10,11,19,22,23,25,117
348548,1,9,15,18,22,31,33,129
348812,7,10,17,18,21,24,35,132
348912,9,10,16,20,25,26,31,137
348952,5,7,9,17,26,31,32,127
349180,1,7,11,14,25,27,30,115
349265,2,6,7,12,17,28,29,101
349297,3,7,9,11,26,32,33,121
349298,2,7,17,18,19,23,31,117
349406,2,6,8,24,25,29,33,127
349543,4,8,9,19,21,25,27,113
349624,4,10,14,18,21,23,27,117
349693,5,8,9,20,26,31,34,133
349745,5,9,11,18,25,26,33,127
349841,1,12,16,17,21,27,28,122
349986,4,10,14,20,23,29,31,131
350035,4,10,17,20,23,24,27,125
350198,4,14,15,20,27,31,35,146
350214,1,10,16,20,25,26,33,131
350251,2,3,16,19,22,29,33,124
350288,3,4,9,18,19,30,34,117
350420,9,12,15,20,21,24,25,126
350572,2,7,9,13,17,24,31,103
350882,7,14,18,20,21,23,29,132
351052,2,7,15,17,21,28,31,121
351085,3,9,10,14,17,25,31,109
351089,1,7,16,20,22,23,33,122
351167,3,5,17,20,24,26,27,122
351462,6,10,18,19,26,29,35,143
351621,7,12,16,20,21,27,29,132
351668,3,14,18,20,25,27,33,140
351709,1,7,10,24,27,30,31,130
351771,2,7,11,17,27,28,32,124
351783,3,7,17,20,21,27,34,129
351838,3,12,15,16,21,29,32,128
352449,3,5,9,16,17,24,32,106
352669,3,4,18,24,25,26,29,129
352754,5,14,16,20,29,32,33,149
353042,3,5,14,18,22,24,33,119
353066,3,9,10,20,22,26,29,119
353137,9,14,17,20,27,30,31,148
353485,9,10,14,20,24,25,27,129
354061,6,9,10,13,23,26,29,116
354066,2,9,15,24,26,31,35,142
354124,7,8,11,14,22,28,35,125
354199,4,7,8,16,21,24,27,107
354221,6,7,9,11,17,23,28,101
354414,4,8,16,19,21,27,33,128
354726,1,5,10,16,22,26,27,107
354974,4,7,11,18,19,27,33,119
354996,7,12,17,18,25,29,32,140
355312,1,7,16,20,21,25,27,117
355331,5,9,15,18,21,24,31,123
355448,2,8,16,19,22,25,29,121
355515,9,10,11,16,22,26,27,121
355677,8,9,11,17,26,31,35,137
355723,4,7,11,14,17,27,30,110
355890,1,9,15,18,22,26,34,125
355953,1,4,18,20,23,27,33,126
355956,3,5,15,24,25,26,30,128
356017,6,9,10,16,21,29,33,124
356021,7,8,9,17,23,27,30,121
356223,3,6,9,20,21,29,33,121
356381,2,9,11,20,24,26,27,119
356671,2,9,15,18,19,24,34,121
356845,1,5,7,16,22,26,28,105
357066,6,7,15,19,24,27,30,128
357183,1,3,9,13,22,27,32,107
357554,7,8,15,16,25,29,31,131
357608,2,3,7,12,21,27,29,101
357700,1,7,18,24,27,31,32,140
357796,3,7,17,18,22,28,31,126
357919,9,14,17,20,23,24,29,136
358113,2,10,11,14,19,24,25,105
358441,3,7,9,14,22,24,27,106
358845,8,9,18,20,22,29,35,141
359016,7,14,17,20,21,26,27,132
359040,1,3,9,20,24,25,27,109
359085,1,4,14,18,19,27,33,116
359606,3,9,18,19,22,24,25,120
359648,1,14,16,18,23,24,29,125
359695,4,9,17,19,25,26,29,129
359855,6,7,11,17,22,30,31,124
359955,4,5,17,18,21,24,25,114
360090,7,9,11,14,19,24,25,109
360114,1,7,14,20,24,28,29,123
360243,6,9,14,20,22,23,27,121
360255,6,9,16,19,29,31,35,145
360446,6,7,14,18,24,29,31,129
360558,3,8,9,13,23,24,35,115
360842,7,12,18,19,22,31,33,142
361451,1,9,15,20,23,24,35,127
361823,1,6,7,20,26,27,31,118
361862,7,9,16,18,22,26,35,133
361919,2,14,17,20,21,31,33,138
362212,7,12,17,20,21,24,27,128
362480,4,8,11,13,27,31,33,127
362503,2,6,11,13,19,23,27,101
362551,7,9,11,14,26,27,33,127
362559,3,12,15,19,24,25,33,131
362784,1,8,18,20,24,25,33,129
363063,7,8,9,13,29,30,33,129
363280,1,6,16,18,19,25,29,114
363805,6,7,9,17,21,24,30,114
363986,6,9,11,19,22,25,29,121
364080,2,12,16,17,29,31,35,142
364092,6,9,18,19,22,28,35,137
364106,1,6,7,24,25,27,28,118
364414,3,4,14,18,19,25,31,114
364586,4,8,10,13,19,27,33,114
364839,5,7,9,19,24,26,32,122
364907,2,6,11,19,25,31,34,128
365169,1,3,7,19,22,24,31,107
365205,2,8,16,19,23,24,29,121
365242,2,7,17,18,27,29,33,133
365312,2,7,8,13,17,26,31,104
365326,4,14,15,16,25,29,35,138
365710,5,12,15,18,22,26,27,125
365732,3,7,9,14,22,24,29,108
365860,8,12,14,20,29,31,33,147
365919,3,8,11,18,22,29,35,126
365945,2,9,16,17,21,27,32,124
366065,1,7,9,17,24,26,28,112
366099,2,4,10,18,19,23,27,103
366124,2,7,8,11,22,31,35,116
366284,5,7,11,16,17,27,30,113
366498,2,5,8,13,22,26,29,105
366521,2,7,11,14,17,27,28,106
366602,2,4,16,19,24,25,29,119
367215,1,6,11,18,24,25,29,114
367457,4,8,17,18,19,25,33,124
367525,3,4,17,20,23,24,31,122
367669,5,8,16,17,19,23,27,115
367835,7,9,14,19,25,28,29,131
367865,7,12,17,18,21,29,34,138
367987,4,6,15,19,29,32,35,140
368069,4,8,15,18,21,27,30,123
368148,6,10,11,14,22,29,35,127
368267,3,4,9,16,26,29,30,117
368439,5,9,10,20,21,27,35,127
368490,7,9,15,19,21,24,30,125
368821,5,8,9,11,24,32,35,124
368980,4,14,15,16,21,25,27,122
369413,1,7,15,17,24,28,31,123
369487,7,9,14,17,21,24,30,122
369702,4,9,15,19,22,29,35,133
369874,6,9,11,17,25,26,30,124
369884,1,10,11,19,22,25,29,117
370066,4,7,17,18,23,26,30,125
370178,4,9,14,18,21,25,27,118
370389,1,7,9,20,23,30,34,124
370537,1,12,16,17,19,25,27,117
370625,1,9,10,16,29,30,34,129
371014,4,12,15,18,21,29,33,132
371146,4,14,17,18,24,27,29,133
371498,1,14,18,20,25,26,29,133
371602,9,14,15,17,25,29,34,143
371631,2,7,14,20,26,27,31,127
371783,3,4,8,11,22,25,28,101
371814,5,10,16,17,23,27,32,130
371848,8,12,17,18,25,26,27,133
371864,1,9,11,18,24,30,34,127
371883,1,12,17,18,21,26,31,126
371912,3,5,7,20,26,27,28,116
371970,7,8,15,24,25,29,31,139
372032,7,8,15,20,24,26,29,129
372267,1,4,17,18,24,25,28,117
372690,6,9,11,16,22,26,27,117
372771,7,10,18,19,24,27,31,136
372827,1,5,16,18,22,32,33,127
372829,1,7,10,11,22,29,33,113
373097,2,7,8,18,23,27,29,114
373217,3,6,7,11,21,26,27,101
373221,4,7,8,19,22,27,28,115
373303,4,7,17,18,24,27,28,125
373352,2,8,9,18,25,29,34,125
373370,8,10,16,17,22,27,31,131
373647,9,14,15,18,22,27,28,133
373854,2,4,8,19,25,27,28,113
374198,4,8,10,13,25,27,29,116
374276,4,14,17,20,21,27,35,138
374357,6,7,17,20,22,26,29,127
374389,2,7,9,19,23,29,32,121
374710,9,10,14,20,21,27,31,132
374917,2,10,11,13,17,24,35,112
374942,3,7,16,17,23,27,32,125
374990,6,7,11,20,26,29,33,132
375049,8,9,11,17,22,25,29,121
375087,2,8,17,18,25,26,29,125
375095,7,9,11,14,23,28,34,126
375278,3,8,17,20,24,27,33,132
375422,2,7,11,12,19,25,35,111
375646,4,7,17,18,25,29,35,135
376270,5,7,14,20,24,25,33,128
376385,4,7,8,14,23,26,27,109
376388,4,10,11,16,21,25,27,114
376509,1,9,10,16,26,29,33,124
376944,1,6,16,20,25,29,35,132
376947,1,5,8,20,23,29,33,119
377112,7,14,16,20,27,29,33,146
377132,3,7,16,18,22,26,35,127
377417,7,9,11,12,17,24,29,109
377672,1,14,15,16,19,24,25,114
377676,1,9,16,20,25,29,35,135
378243,2,4,10,12,21,25,31,105
378583,8,14,16,17,23,27,31,136
378610,3,5,9,20,26,27,29,119
378806,8,10,18,20,27,31,33,147
378939,5,12,16,17,22,27,34,133
378985,4,8,10,19,22,27,35,125
379401,2,7,9,17,21,27,28,111
379459,10,14,16,17,19,27,34,137
379461,3,4,9,20,21,24,33,114
379751,1,5,10,11,22,25,28,102
379773,5,6,7,17,23,27,32,117
380061,2,8,16,19,24,25,29,123
380131,5,6,16,20,25,26,29,127
380139,1,7,9,11,25,26,34,113
380159,2,9,14,18,19,25,29,116
380604,4,8,9,20,21,25,31,118
380657,4,5,17,18,24,31,35,134
380867,2,8,9,16,25,29,35,124
380911,4,8,9,11,17,23,35,107
381184,3,4,15,19,25,27,34,127
381820,1,9,17,20,23,24,34,128
381850,4,7,17,18,19,23,25,113
381941,4,9,15,18,19,26,31,122
381960,7,8,16,17,21,24,27,120
381998,2,9,11,19,21,25,32,119
382035,4,5,11,20,21,25,34,120
382074,4,8,11,20,21,27,32,123
382309,7,9,10,11,17,24,32,110
382558,3,14,17,18,26,27,33,138
382575,2,6,9,19,29,31,35,131
383005,2,10,11,19,23,25,30,120
383278,3,7,9,14,22,24,30,109
383387,2,7,11,19,22,24,30,115
383596,1,6,14,16,22,23,27,109
383603,2,12,15,16,26,29,35,135
383610,9,12,18,19,22,29,31,140
383647,2,8,11,13,23,26,27,110
383660,3,6,10,16,17,23,27,102
383969,9,12,16,19,21,25,29,131
384112,1,9,14,20,24,26,29,123
384136,7,8,10,14,17,27,33,116
384560,7,12,17,20,21,27,33,137
384583,2,7,8,11,22,25,35,110
384775,2,3,9,13,17,28,31,103
384909,4,8,9,14,29,31,35,130
384940,5,7,9,11,26,32,35,125
385031,1,6,17,20,21,26,33,124
385172,1,7,11,20,24,25,28,116
385449,3,10,18,19,27,29,33,139
385721,1,7,14,19,22,28,32,123
385826,7,8,17,18,21,27,28,126
386072,2,4,16,19,23,29,30,123
386080,3,14,16,18,23,28,29,131
386324,2,8,9,13,19,28,29,108
386342,2,4,15,17,19,25,31,113
386355,7,8,11,13,21,26,27,113
386369,2,4,8,17,25,27,29,112
387654,5,8,9,20,26,29,34,131
387782,8,9,10,19,29,31,35,141
387784,5,9,11,16,21,26,29,117
387863,2,5,9,20,22,26,27,111
388034,4,7,11,17,21,27,30,117
388394,9,10,18,19,25,28,29,138
388654,9,10,14,16,23,26,29,127
388923,1,9,14,24,25,26,30,129
388925,9,14,18,20,23,27,31,142
389012,2,9,15,19,24,25,30,124
389333,5,9,14,20,23,29,33,133
389402,6,7,9,20,22,26,31,121
389445,6,14,16,20,25,27,31,139
389662,2,4,11,17,25,28,29,116
389831,7,8,14,17,27,31,34,138
389864,1,7,9,13,22,30,33,115
389906,2,5,11,19,25,28,29,119
390188,2,8,11,12,21,25,33,112
390419,1,4,7,18,29,31,33,123
390552,1,7,11,18,22,31,35,125
390628,3,7,9,14,26,29,33,121
390739,7,9,14,18,19,24,34,125
390846,1,4,8,16,23,27,33,112
390875,2,6,7,12,17,29,31,104
391439,9,10,14,20,29,31,32,145
391563,1,6,17,20,27,29,33,133
391624,7,9,16,20,21,24,27,124
391651,4,5,8,20,21,27,33,118
391837,2,3,9,20,21,24,32,111
391853,6,14,16,20,25,29,33,143
391901,1,8,11,13,22,28,32,115
391949,1,6,17,18,24,28,33,127
392512,4,5,14,20,29,31,35,138
392533,5,7,17,24,27,28,33,141
392607,1,7,9,16,24,31,35,123
392742,2,6,9,19,27,29,35,127
392907,5,14,16,20,25,29,31,140
393104,1,3,7,20,25,29,32,117
393178,1,9,11,20,24,28,34,127
393192,4,5,11,20,21,25,30,116
393358,2,6,16,20,21,27,35,127
393540,1,6,10,16,27,29,35,124
393723,3,7,8,18,26,29,32,123
393765,8,14,16,17,23,27,34,139
393929,9,14,15,18,24,28,35,143
393939,1,7,11,12,27,31,34,123
394142,3,7,15,18,24,26,34,127
394285,5,9,14,20,24,25,29,126
394522,1,5,7,12,22,27,31,105
394971,3,7,14,16,22,24,31,117
395076,2,8,11,20,24,29,33,127
395153,5,9,10,20,22,26,31,123
395278,1,5,16,17,22,23,31,115
395315,4,5,17,20,21,29,35,131
395360,1,7,11,12,22,23,34,110
395763,4,8,15,18,21,25,32,123
395974,3,9,17,18,22,24,29,122
396030,5,9,15,18,22,26,33,128
396299,1,7,9,18,24,29,33,121
396396,5,9,11,18,21,26,28,118
396839,10,14,15,16,23,24,25,127
396849,1,7,18,19,22,27,31,125
396912,7,12,16,18,26,29,35,143
396965,7,9,10,11,17,24,35,113
397038,3,12,14,18,29,32,33,141
397061,1,6,16,19,22,23,27,114
397171,1,4,7,13,27,28,31,111
397366,6,7,11,17,22,30,32,125
397552,1,7,8,18,24,27,28,113
397598,3,8,9,18,24,25,29,116
397971,1,5,7,20,27,28,31,119
398413,5,6,9,20,21,24,27,112
398547,4,12,16,19,22,29,33,135
398575,2,7,18,19,25,29,31,131
398629,2,7,9,13,26,28,29,114
398652,1,5,17,18,23,26,32,122
398709,1,9,16,17,22,26,27,118
399017,2,4,18,19,23,27,29,122
399211,2,9,11,16,22,26,35,121
400099,4,7,10,13,17,27,29,107
400113,3,6,9,18,26,29,30,121
400470,1,6,10,18,26,29,35,125
400497,10,14,16,20,23,29,35,147
400515,1,9,16,19,22,26,32,125
400552,2,7,11,12,21,25,31,109
400609,3,4,9,14,23,25,27,105
400841,4,5,16,17,27,31,33,133
400851,1,9,11,13,24,30,33,121
401056,6,7,9,13,17,27,30,109
401273,1,14,18,20,22,27,33,135
401289,2,4,8,16,21,25,29,105
401466,9,12,17,18,21,26,32,135
401589,7,8,11,18,23,24,34,125
401679,2,7,18,19,22,28,31,127
402580,6,10,11,13,19,23,27,109
402593,10,12,16,17,26,27,29,137
402644,7,14,17,20,27,31,33,149
402691,5,10,18,20,25,26,29,133
402872,7,8,14,18,19,29,32,127
402940,1,9,11,19,25,26,30,121
403192,4,9,11,20,22,26,35,127
403222,1,14,18,20,27,31,33,144
403236,3,7,15,20,26,29,31,131
403414,1,7,8,12,17,27,35,107
403416,7,10,11,20,26,29,30,133
403420,9,14,16,17,22,27,31,136
403439,7,14,15,20,22,24,27,129
403523,5,6,18,24,25,26,29,133
403618,1,4,7,16,24,27,31,110
403677,2,4,15,19,24,25,32,121
403966,3,7,9,14,24,30,34,121
404007,2,3,7,17,24,30,32,115
404026,1,14,16,20,26,27,29,133
404092,4,7,18,19,25,29,34,136
404108,4,7,8,20,27,28,33,127
404316,3,4,17,18,22,29,35,128
404324,3,7,18,19,24,25,27,123
404524,5,8,11,20,22,24,31,121
404563,5,9,10,16,19,24,33,116
404564,6,8,9,20,25,31,35,134
404848,9,12,14,19,22,25,29,130
404930,3,7,8,17,22,28,29,114
405103,8,12,15,20,25,31,33,144
405468,2,8,11,16,23,27,31,118
405539,3,4,17,18,21,26,27,116
405794,3,7,18,19,24,25,33,129
405904,9,10,14,18,24,25,27,127
406091,1,9,15,20,21,24,31,121
406106,1,5,14,16,22,28,31,117
406498,6,10,11,16,21,27,34,125
406636,2,5,8,11,23,27,35,111
406659,2,7,8,11,22,25,33,108
406683,4,12,16,18,21,25,29,125
406828,3,4,8,24,25,27,31,122
406961,2,7,11,14,25,29,35,123
407234,4,8,15,16,27,32,33,135
407418,1,8,9,13,24,28,34,117
407554,7,8,9,13,19,24,29,109
407560,2,8,11,13,17,26,33,110
407636,6,9,17,20,21,24,30,127
407666,2,6,11,13,19,26,29,106
407723,5,9,16,19,21,24,27,121
407780,7,8,11,20,21,27,31,125
408229,1,12,14,18,22,25,33,125
408532,7,12,17,18,23,27,32,136
408542,4,7,9,13,21,29,32,115
408638,3,6,9,11,21,25,30,105
408649,1,14,16,20,27,32,33,143
408654,2,4,8,20,23,29,35,121
408679,9,10,15,20,21,25,31,131
408735,5,7,17,18,22,25,31,125
408778,3,12,16,20,21,25,27,124
408826,1,5,17,18,22,26,32,121
408891,5,9,14,20,22,26,31,127
408950,5,6,9,20,26,27,30,123
409046,1,4,7,20,25,26,30,113
409109,4,8,9,11,19,25,34,110
409125,4,6,15,18,19,23,29,114
409217,4,7,16,19,25,27,31,129
409289,7,14,15,16,21,24,25,122
409327,1,3,7,16,22,29,32,110
409456,1,4,8,14,22,27,35,111
409512,4,8,16,19,22,27,31,127
409562,1,3,9,19,24,28,35,119
409583,2,6,7,12,21,29,34,111
409711,4,8,14,20,25,27,33,131
409828,1,7,14,20,25,26,29,122
409880,7,8,9,13,26,29,32,124
410083,8,12,16,19,21,27,29,132
410240,1,7,8,11,22,24,27,100
410612,4,14,17,20,21,26,27,129
411058,10,14,15,16,19,29,35,138
411124,6,10,11,20,21,24,27,119
411190,7,9,11,17,22,27,28,121
411214,7,8,11,13,24,27,29,119
411407,2,7,11,13,17,25,30,105
411819,6,8,10,16,17,27,33,117
411940,1,4,7,12,22,27,31,104
412155,5,6,9,13,19,24,30,106
412561,6,9,11,20,22,26,35,129
412643,1,9,16,17,23,26,27,119
412722,3,8,11,16,22,29,33,122
412918,8,9,16,18,22,27,33,133
413165,2,8,16,17,21,25,29,118
413167,9,10,14,20,21,24,27,125
413277,3,4,10,14,19,27,35,112
413289,1,7,11,18,27,28,31,123
413417,1,4,7,19,22,24,28,105
413446,1,7,10,17,21,26,27,109
413621,3,9,18,19,22,25,31,127
413637,1,7,11,18,26,27,30,120
413854,3,9,17,18,24,25,29,125
414038,5,8,16,20,23,25,29,126
414152,3,4,17,20,25,31,35,135
414356,7,8,18,20,24,25,29,131
414371,7,9,11,24,25,26,32,134
414430,2,7,9,13,21,24,34,110
414538,4,12,15,16,21,27,35,130
414866,2,7,8,18,22,25,27,109
415318,8,9,18,24,25,27,28,139
415379,3,6,16,20,21,25,27,118
415553,4,6,11,16,17,27,31,112
415571,2,3,11,13,17,25,32,103
415574,2,8,9,13,17,27,34,110
415723,10,12,15,20,25,26,29,137
416139,4,5,8,20,27,28,33,125
416881,2,4,8,13,25,27,34,113
417018,3,9,14,24,26,28,35,139
417109,2,6,11,17,19,26,35,116
417325,6,14,16,17,22,27,31,133
417537,7,10,11,18,26,27,32,131
417686,2,9,15,20,25,26,29,126
418238,1,9,11,20,26,30,34,131
418683,4,8,15,19,25,29,35,135
418854,6,10,17,20,21,27,33,134
418898,10,14,16,17,25,27,34,143
418909,3,9,16,20,21,27,32,128
418963,2,7,9,11,17,30,31,107
419163,1,14,17,18,23,28,33,134
419171,2,8,16,19,23,29,35,132
419472,4,9,16,19,22,31,35,136
419505,5,14,16,20,27,31,32,145
419652,7,9,17,18,23,30,34,138
419743,3,4,17,18,22,23,28,115
419837,1,5,8,20,26,29,31,120
419892,9,14,17,20,21,31,33,145
419913,1,8,11,20,23,24,29,116
420048,1,8,17,18,21,26,32,123
420100,3,9,14,17,25,26,29,123
420103,3,7,9,17,22,24,35,117
420160,4,10,17,20,22,23,27,123
420186,9,14,16,20,25,29,31,144
420254,7,9,11,12,19,24,25,107
420483,1,10,17,20,25,26,30,129
420516,6,9,11,19,21,25,30,121
420771,2,8,9,20,21,24,33,117
421051,9,10,15,19,24,32,35,144
421235,7,12,14,18,19,29,34,133
421292,3,9,17,20,24,25,27,125
421418,2,9,17,20,23,24,28,123
421645,7,8,14,18,22,27,31,127
421834,1,5,7,11,27,30,34,115
422120,2,14,16,20,23,25,29,129
422265,7,12,16,17,21,27,31,131
422399,4,5,14,17,21,25,27,113
422450,1,9,14,19,24,25,28,120
422455,1,3,18,20,22,27,33,124
422740,9,14,15,19,24,25,28,134
422819,4,9,14,20,25,29,32,133
422822,3,7,17,18,23,24,31,123
422834,1,9,15,18,22,27,34,126
422931,6,14,15,20,29,32,33,149
422956,2,5,9,20,21,27,35,119
423321,1,10,16,18,22,25,35,127
423641,6,7,16,19,22,26,31,127
423674,4,10,11,19,23,27,35,129
423823,2,3,11,13,19,30,34,112
423871,6,10,11,18,21,23,29,118
424035,5,6,9,16,17,23,27,103
424053,5,7,17,18,24,28,29,128
424079,8,9,10,13,26,29,35,130
424114,3,9,16,17,22,26,31,124
424208,1,10,11,18,19,23,29,111
424271,1,14,16,18,22,25,31,127
424330,4,7,11,16,21,27,33,119
424409,1,5,8,16,22,29,34,115
424441,1,3,16,17,22,26,29,114
424448,2,6,17,20,23,29,33,130
424623,1,7,17,20,22,23,27,117
424670,7,10,11,17,22,24,28,119
424892,3,7,11,18,19,24,27,109
424929,1,7,11,13,22,24,35,113
425050,2,6,7,14,23,26,29,107
425252,1,4,7,16,27,28,31,114
425281,7,14,17,20,22,24,33,137
425716,5,7,17,18,23,26,30,126
425820,1,7,17,20,26,30,33,134
426171,2,7,8,11,21,27,35,111
426305,7,12,17,18,21,26,34,135
426326,3,8,9,13,24,28,32,117
426385,3,12,16,19,21,27,29,127
426393,7,9,14,18,24,28,29,129
426559,2,9,15,16,19,29,34,124
426615,8,9,14,18,19,24,27,119
426796,5,6,17,18,21,26,27,120
426832,2,4,8,11,25,28,31,109
427112,2,5,7,11,17,30,32,104
427144,1,7,16,18,21,24,25,112
427150,4,12,14,20,23,25,29,127
427157,3,14,16,17,21,24,27,122
427256,4,8,10,18,19,23,27,109
427536,2,14,16,19,25,29,30,135
427540,1,6,10,20,26,27,35,125
427648,1,9,18,20,22,27,28,125
427666,9,10,11,13,17,30,32,122
427982,2,7,17,18,21,29,35,129
428076,6,7,15,19,21,29,32,129
428185,4,5,15,18,19,23,25,109
428195,2,3,9,18,21,24,25,102
428284,9,10,15,19,24,26,35,138
428287,1,5,9,13,24,28,34,114
428547,8,10,11,16,25,27,29,126
428693,7,9,14,18,19,25,29,121
428798,4,6,10,13,17,27,35,112
429040,3,14,17,18,27,30,33,142
429357,1,7,11,20,25,27,28,119
429622,1,7,11,14,27,28,35,123
429678,5,7,11,19,22,28,30,122
429739,1,5,9,11,24,26,35,111
429775,9,12,17,18,26,27,31,140
429850,7,9,11,14,25,30,31,127
429908,4,8,14,17,23,25,27,118
430138,2,6,15,16,21,28,29,117
430213,1,7,10,11,27,32,35,123
430225,1,9,17,18,23,26,27,121
430740,4,5,7,17,23,26,27,109
430759,7,9,15,20,26,27,30,134
431200,1,6,7,18,24,25,28,109
431219,9,10,16,19,23,29,30,136
431291,2,7,10,16,21,24,25,105
431351,5,9,11,16,24,26,31,122
431438,2,7,11,17,25,28,30,120
431521,7,9,11,19,24,30,34,134
431579,7,9,11,12,17,30,34,120
431908,2,10,16,17,23,27,35,130
432127,1,4,16,20,21,23,27,112
432152,7,8,10,11,17,27,29,109
432321,1,4,7,18,22,28,35,115
432339,9,14,16,20,25,30,31,145
432497,2,8,11,17,22,25,29,114
433129,3,6,7,20,21,27,35,119
433159,6,7,17,18,21,23,27,119
433323,1,10,16,18,21,29,33,128
434028,5,9,11,14,19,25,34,117
434058,2,9,16,20,21,27,28,123
434108,1,7,15,24,25,28,35,135
434277,7,8,9,14,24,29,33,124
434507,2,4,18,19,22,23,29,117
434713,4,8,17,20,23,27,28,127
434715,3,7,15,17,26,31,32,131
434962,4,8,10,18,19,27,31,117
434979,4,14,18,19,25,27,29,136
435043,6,7,11,17,22,28,35,126
435059,1,7,17,19,22,26,27,119
435145,5,9,11,17,25,30,34,131
435161,2,3,11,13,17,24,33,103
435362,6,9,14,18,24,27,29,127
435381,1,7,16,20,22,27,28,121
435387,4,8,9,18,23,29,34,125
435402,6,8,9,19,25,29,34,130
435608,4,9,17,18,24,25,28,125
435720,5,7,11,14,22,23,27,109
435830,2,10,11,19,21,25,30,118
435930,2,8,9,19,23,24,35,120
436222,9,14,15,16,19,28,29,130
436251,1,6,7,20,24,27,28,113
436326,5,8,11,18,22,24,35,123
436484,1,5,16,19,22,29,35,127
437065,4,7,8,13,22,29,33,116
437074,2,8,11,17,25,27,31,121
437294,5,9,14,16,22,23,29,118
437691,1,3,9,13,23,24,30,103
437704,2,6,11,13,17,24,27,100
437858,4,7,15,18,19,25,30,118
437943,8,9,15,20,25,31,35,143
437955,8,12,16,18,21,29,31,135
438009,6,9,10,12,17,25,31,110
438024,7,8,11,14,17,27,35,119
438028,5,9,11,16,25,26,35,127
438297,2,5,16,19,23,27,29,121
438337,1,7,15,17,19,24,34,117
438461,1,6,11,20,25,26,30,119
438535,3,7,16,19,22,23,31,121
438643,3,9,14,18,21,24,30,119
438795,9,12,18,19,23,28,29,138
438809,5,14,16,24,27,31,33,150
438870,6,7,11,19,26,27,32,128
438928,7,9,10,13,21,24,31,115
438931,1,5,16,18,24,29,31,124
439175,5,9,15,20,21,28,29,127
439571,6,8,9,20,21,27,31,122
439597,3,9,11,18,23,26,30,120
439862,1,5,7,19,22,23,32,109
440437,4,14,15,18,21,29,33,134
440493,4,7,8,13,22,23,31,108
440532,4,9,17,18,24,25,29,126
440577,5,8,9,18,19,23,29,111
440654,1,9,15,16,25,29,32,127
440871,2,4,7,17,19,23,31,103
440898,4,5,15,19,24,29,35,131
440925,8,10,14,17,25,26,27,127
440937,2,6,10,17,25,26,31,117
441037,4,6,9,13,19,24,28,103
441115,2,6,11,12,21,24,25,101
441252,4,7,15,18,19,29,35,127
441331,2,4,17,19,21,25,27,115
441491,5,12,16,17,22,24,31,127
441764,1,8,10,20,23,29,33,124
442052,1,7,14,19,22,31,35,129
442196,2,7,10,17,25,29,35,125
442797,4,8,16,18,25,27,33,131
442888,1,9,16,20,21,24,30,121
443027,8,9,14,24,25,28,31,139
443074,6,10,11,16,19,27,29,118
443086,9,12,14,18,19,24,33,129
443124,5,9,11,13,22,26,33,119
443132,9,10,16,19,25,29,30,138
443205,1,6,8,20,23,27,33,118
443224,8,9,10,16,17,25,29,114
443741,1,4,11,13,17,27,28,101
444715,1,9,15,20,24,27,33,129
444858,1,5,7,20,21,27,34,115
444921,9,14,15,16,23,24,28,129
444935,3,5,9,11,26,32,35,121
445310,4,14,18,20,27,31,33,147
445423,5,8,11,13,26,27,30,120
445444,2,8,17,18,23,26,27,121
445679,7,9,11,20,24,26,28,125
445991,1,7,17,18,23,27,30,123
446040,1,14,16,18,23,26,29,127
446055,3,7,17,18,21,23,30,119
446125,3,7,17,20,23,28,29,127
446259,8,9,18,19,22,25,30,131
446592,2,8,11,12,17,25,27,102
447198,5,9,10,19,24,25,30,122
447439,1,5,7,20,25,26,28,112
447454,9,14,16,24,25,29,31,148
447475,3,4,18,20,21,24,27,117
447490,4,7,18,24,26,27,31,137
447817,1,7,15,16,24,25,29,117
447966,3,5,17,20,24,30,33,132
448289,5,7,8,11,24,27,31,113
448316,7,8,9,19,22,23,29,117
448442,1,9,14,20,24,27,29,124
448705,6,8,9,18,25,29,31,126
448757,3,4,17,18,21,23,32,118
448763,3,10,16,19,22,31,35,136
449082,4,5,8,16,27,29,33,122
449207,7,12,17,18,21,24,30,129
449212,4,5,8,18,25,30,31,121
449283,7,14,18,20,23,27,32,141
449429,2,6,9,17,22,25,31,112
449982,1,6,7,11,27,30,31,113
450086,6,8,11,13,17,24,27,106
450360,7,9,10,13,17,27,28,111
450843,6,7,14,20,23,27,35,132
450953,3,8,9,20,23,27,30,120
451095,9,12,14,17,25,29,31,137
451276,2,7,8,17,19,27,31,111
451334,3,9,10,14,25,29,32,122
451402,4,8,9,12,25,28,31,117
451531,5,6,11,18,19,23,27,109
451892,5,10,16,17,27,31,32,138
452154,1,5,7,16,22,27,29,107
452160,1,7,10,20,25,26,29,118
452189,1,3,9,13,17,26,34,103
452613,3,12,16,17,22,28,29,127
452616,7,8,9,11,17,25,34,111
452749,5,9,15,18,19,24,27,117
453023,1,4,8,18,21,23,27,102
453047,1,9,10,13,26,29,35,123
453444,7,9,11,17,26,30,31,131
454084,7,9,10,13,17,24,31,111
454128,1,5,9,17,25,28,34,119
454143,4,6,7,11,21,27,29,105
454145,1,6,16,19,22,23,33,120
454180,1,4,8,14,24,25,27,103
454198,2,8,11,18,23,27,28,117
454582,10,12,18,19,24,29,33,145
454600,1,4,17,20,24,25,30,121
454859,2,7,18,20,21,23,27,118
455094,5,9,15,16,21,28,29,123
455282,3,7,9,24,25,26,34,128
455317,1,8,9,13,19,24,28,102
455341,1,7,15,16,24,28,34,125
455782,3,9,14,20,27,31,32,136
456091,5,9,10,20,26,29,33,132
456105,1,10,17,20,23,26,30,127
456116,10,14,16,20,21,29,31,141
456314,1,4,9,13,21,27,28,103
456417,1,12,16,20,26,27,31,133
456501,2,9,16,20,21,29,35,132
456538,6,9,10,14,17,29,35,120
456694,4,6,7,11,21,25,27,101
457298,7,9,11,13,26,30,33,129
457564,5,7,9,11,21,26,32,111
457670,2,7,8,11,21,23,29,101
457782,2,5,16,18,21,24,25,111
457855,2,7,10,11,17,24,34,105
458116,2,4,11,19,21,24,25,106
458142,3,7,14,20,25,27,30,126
458236,8,9,18,20,26,29,33,143
458574,1,5,18,20,24,26,29,123
458685,7,8,11,12,17,27,31,113
458690,1,14,16,18,22,29,31,131
458793,1,4,10,11,27,31,35,119
459045,6,9,18,19,23,29,35,139
459141,1,7,16,20,22,32,33,131
459150,4,7,15,19,25,29,32,131
459267,6,14,15,18,24,27,33,137
459277,1,9,17,18,21,23,30,119
459373,2,4,7,20,25,26,29,113
459492,4,6,8,13,19,27,33,110
459522,4,8,16,20,23,29,33,133
459822,1,7,18,19,23,29,34,131
460127,1,7,8,16,23,24,27,106
460230,2,4,10,13,26,29,33,117
460297,6,14,17,18,27,30,33,145
460368,8,10,18,24,25,29,33,147
460461,4,14,18,19,22,29,35,141
460477,1,4,9,20,23,26,30,113
460539,6,12,18,19,29,31,33,148
460640,6,10,16,17,27,28,35,139
460839,4,10,14,20,27,31,33,139
460883,9,12,14,18,21,28,29,131
460919,2,10,14,16,29,31,33,135
461089,7,8,14,18,22,27,29,125
461093,4,7,8,19,27,28,33,126
461217,1,14,18,20,29,30,33,145
461329,2,3,11,17,25,29,34,121
461483,1,9,15,16,19,24,27,111
461708,3,7,9,11,26,30,31,117
461960,4,5,8,24,25,27,31,124
462207,5,7,11,14,22,23,30,112
462244,1,5,7,20,22,28,34,117
462278,3,8,9,12,25,29,31,117
462396,4,8,10,13,22,29,31,117
462559,2,5,11,18,22,26,31,115
462614,4,7,11,18,26,29,32,127
463002,5,14,15,18,24,26,29,131
463121,1,7,10,13,22,29,33,115
463615,4,10,17,20,23,27,29,130
463663,3,4,18,19,23,26,29,122
464027,6,14,16,17,21,25,27,126
464107,2,7,10,11,17,23,35,105
464298,4,8,11,20,23,24,29,119
464320,3,9,14,18,24,29,35,132
464346,7,9,10,13,26,28,29,122
464604,1,5,10,16,27,29,30,118
464794,4,9,10,13,19,31,33,119
464893,1,7,18,20,27,30,34,137
464918,1,3,9,11,24,25,28,101
464941,1,6,9,14,29,31,35,125
464973,4,8,10,20,23,25,27,117
465101,9,12,17,20,26,27,30,141
465256,5,9,14,16,22,29,33,128
465310,1,7,17,20,21,32,33,131
465508,3,8,10,16,22,29,33,121
466106,2,5,8,11,25,30,34,115
466188,9,14,17,18,25,28,31,142
466225,1,12,14,18,26,29,35,135
466437,7,9,11,18,19,25,28,117
466439,3,8,9,20,23,24,28,115
466559,1,3,18,24,29,30,33,138
466592,4,14,17,20,23,27,32,137
466746,3,6,9,13,17,24,34,106
466761,1,5,9,20,25,28,31,119
466794,9,12,18,19,22,25,29,134
466848,1,10,18,24,27,28,33,141
466901,2,7,8,11,26,29,30,113
467221,8,9,17,24,25,28,31,142
467276,3,12,17,18,22,26,29,127
467359,7,14,16,18,22,23,33,133
467424,1,4,17,18,21,25,31,117
467517,3,7,16,19,24,27,30,126
467632,1,4,14,18,21,27,35,120
467769,1,7,9,20,24,30,34,125
467804,1,7,17,24,26,27,30,132
467860,4,10,14,18,21,25,33,125
467918,1,4,18,19,25,29,31,127
468023,1,4,7,20,29,31,35,127
468178,1,4,10,16,23,24,27,105
468317,5,8,16,20,23,24,29,125
468681,3,9,14,18,22,24,33,123
468711,4,5,11,13,22,26,28,109
468785,1,3,9,13,22,29,34,111
469047,1,8,11,17,22,31,35,125
469255,1,3,7,16,22,26,34,109
469425,4,9,14,20,29,31,33,140
469458,1,5,11,13,22,26,33,111
469491,4,14,15,19,24,25,33,134
469703,2,4,11,17,21,24,35,114
469995,9,12,18,19,25,29,30,142
470108,1,5,9,16,24,26,32,113
470769,5,8,9,24,25,30,34,135
471503,2,6,11,18,21,27,35,120
471563,2,6,11,24,25,26,31,125
471648,5,12,15,20,25,26,29,132
471675,1,6,9,20,23,24,30,113
471871,1,7,11,17,22,31,34,123
471884,1,9,10,16,17,28,32,113
472030,8,10,15,16,22,25,29,125
472072,1,6,10,20,23,29,33,122
472104,1,6,9,16,23,25,29,109
472135,4,8,9,19,21,24,25,110
472400,4,7,14,20,29,31,35,140
472514,1,6,9,20,25,26,29,116
472678,8,14,16,24,27,29,31,149
472769,2,3,7,14,22,27,28,103
472827,8,9,11,18,24,27,31,128
472864,6,9,18,19,23,26,29,130
473307,1,3,7,20,25,30,35,121
473484,3,14,16,20,21,29,32,135
473558,1,7,10,17,22,25,29,111
473677,1,6,14,18,22,27,33,121
473794,1,9,11,13,19,26,28,107
473935,1,6,11,16,22,26,33,115
474010,3,7,16,17,22,31,33,129
474150,2,7,8,17,21,29,32,116
474234,1,7,14,20,22,31,35,130
474255,6,8,10,16,27,29,33,129
474723,5,7,11,18,26,27,35,129
474823,7,14,16,20,23,29,35,144
474870,4,8,15,20,23,25,29,124
475110,6,9,10,19,24,25,34,127
475185,9,14,15,18,24,28,29,137
475198,1,14,16,20,24,25,35,135
475246,4,6,17,18,21,23,28,117
475279,3,5,9,13,17,24,32,103
475333,2,4,8,16,23,29,31,113
475704,4,14,15,20,23,27,32,135
475754,3,7,18,24,26,29,35,142
475837,5,6,9,20,26,29,31,126
475935,3,7,16,18,21,24,25,114
475999,4,7,8,19,21,25,27,111
476093,4,8,11,16,27,28,33,127
476316,1,3,7,16,22,29,35,113
476335,3,4,7,20,21,26,29,110
476474,3,9,17,20,24,31,32,136
476479,4,7,8,17,22,23,27,108
476530,7,10,11,19,27,32,33,139
476643,1,10,15,16,19,29,35,125
476666,1,7,15,17,21,24,30,115
476731,1,12,14,16,22,23,33,121
476837,1,7,11,18,19,28,29,113
476864,3,6,16,20,25,26,29,125
477085,3,8,9,20,24,26,29,119
477173,4,7,10,14,21,27,30,113
477775,1,4,15,19,25,30,31,125
477777,9,12,14,18,22,23,35,133
477803,1,9,18,20,25,26,29,128
477823,4,7,10,14,19,27,30,111
477999,1,3,9,14,25,28,29,109
478103,1,5,8,20,26,29,34,123
478341,7,12,14,18,26,29,31,137
478408,6,7,14,18,19,24,29,117
478454,4,7,10,14,19,27,28,109
478521,1,3,7,20,23,25,28,107
478638,3,12,18,19,22,23,33,130
478671,2,6,7,17,23,26,29,110
479047,7,8,18,19,22,25,35,134
479113,7,10,11,14,21,27,32,122
479237,1,5,8,18,24,26,27,109
479298,6,8,17,18,27,29,33,138
479305,1,10,16,24,27,28,29,135
479536,7,8,9,11,17,27,30,109
479702,1,5,14,18,24,27,33,122
479834,8,9,15,20,21,27,31,131
480080,1,3,7,11,22,30,34,108
480189,1,12,15,16,22,25,31,122
480341,1,5,11,20,22,28,34,121
480546,2,7,11,16,21,23,29,109
480653,1,4,10,20,22,31,35,123
480683,4,6,15,19,25,29,30,128
480950,5,9,14,19,29,30,35,141
481115,2,7,15,19,24,25,35,127
481324,7,10,14,16,27,29,35,138
481474,5,7,9,17,24,28,30,120
481729,4,12,16,19,22,25,27,125
482146,5,6,8,11,22,25,29,106
482291,4,10,17,20,21,24,29,125
482317,1,5,7,20,22,25,32,112
483008,2,8,17,18,19,23,33,120
483515,6,9,16,20,21,26,31,129
483576,2,7,11,17,24,27,32,120
483603,3,7,9,12,24,26,29,110
483662,7,9,11,19,25,30,32,133
483697,7,9,18,20,24,26,29,133
483939,8,12,16,17,22,27,33,135
484042,1,7,11,20,22,27,30,118
484085,1,12,18,19,22,25,33,130
484279,3,6,7,20,21,29,35,121
484305,1,3,7,17,27,28,34,117
484325,1,3,7,11,22,28,32,104
484526,7,14,16,20,23,25,31,136
484606,1,7,14,24,27,28,33,134
484677,3,4,10,19,22,25,29,112
484683,5,9,10,16,21,24,31,116
484718,4,7,11,12,17,24,27,102
485159,4,6,15,17,25,27,31,125
485165,1,9,11,13,17,24,32,107
485194,7,10,11,17,22,27,28,122
485273,5,9,18,19,24,27,33,135
485370,1,6,9,20,24,29,35,124
485411,9,10,17,18,21,23,31,129
485448,3,9,14,18,19,24,28,115
485482,2,5,11,13,17,28,32,108
485541,3,7,8,12,22,28,31,111
485619,3,7,9,17,26,31,34,127
485630,2,3,7,19,22,23,29,105
486011,4,5,9,14,23,29,35,119
486137,4,7,10,14,17,26,27,105
486182,2,7,8,11,22,24,31,105
486196,3,4,8,14,27,32,35,123
486357,7,8,16,20,21,27,28,127
486458,4,8,17,20,25,28,31,133
486505,1,6,10,20,23,26,29,115
486667,9,10,18,19,21,24,28,129
487096,2,7,11,14,17,29,32,112
487115,2,9,11,17,24,25,29,117
487138,3,8,11,20,23,25,29,119
487267,3,9,11,13,22,26,35,119
487369,3,8,9,14,17,31,35,117
487432,3,6,9,20,22,26,31,117
487563,3,6,16,20,26,27,31,129
487650,5,12,16,17,21,24,27,122
487767,7,9,14,18,24,25,27,124
487781,5,6,18,20,26,29,33,137
487905,4,8,9,18,22,23,29,113
487939,4,6,15,19,27,29,35,135
488150,1,14,16,24,27,29,33,144
488555,1,5,11,20,25,31,34,127
489011,1,7,17,18,21,26,27,117
489256,7,8,9,11,22,26,28,111
489369,1,7,9,20,22,27,31,117
489446,2,3,11,12,21,25,31,105
489719,4,5,11,20,22,26,31,119
489808,6,7,17,20,26,29,30,135
489915,3,7,8,13,22,28,29,110
489927,5,9,15,16,24,26,30,125
489950,4,7,8,18,27,32,33,129
490101,5,9,11,19,25,26,28,123
490141,2,10,11,12,19,23,25,102
491233,1,5,7,14,22,28,31,108
491251,2,9,11,20,26,27,30,125
491668,1,9,18,24,25,30,34,141
491720,4,7,9,20,26,31,35,132
491751,2,8,11,17,25,28,32,123
491879,4,5,11,13,22,26,31,112
492007,4,12,14,16,21,27,35,129
492073,3,7,10,20,26,27,34,127
492166,2,4,17,18,22,23,25,111
492463,2,9,10,13,19,24,28,105
492534,2,10,16,19,27,29,33,136
492546,7,9,11,18,19,28,34,126
492793,1,4,7,11,22,30,34,109
492837,2,6,17,20,26,31,35,137
492876,2,3,17,18,21,27,33,121
492939,3,8,9,12,19,24,35,110
493009,4,8,14,20,23,25,27,121
493015,1,10,11,16,17,23,27,105
493065,2,10,11,13,17,28,33,114
493175,8,9,15,24,25,26,28,135
493312,2,7,11,17,22,25,28,112
493449,2,7,11,17,27,28,30,122
493708,6,9,16,17,19,23,31,121
494052,1,9,10,16,24,25,28,113
494176,5,9,11,18,21,31,34,129
494231,5,6,9,16,19,24,25,104
494499,6,7,11,20,26,31,34,135
494625,4,9,10,12,19,31,35,120
494669,2,8,9,18,25,28,29,119
494713,8,9,15,20,24,25,28,129
494760,7,8,11,13,22,24,27,112
494985,9,12,15,18,21,24,28,127
495020,1,9,16,18,22,24,33,123
495025,6,7,10,11,21,25,27,107
495212,3,9,16,17,21,27,30,123
495326,5,14,16,18,23,26,29,131
495540,4,6,17,20,21,27,31,126
495605,3,9,17,18,22,30,32,131
495718,7,9,10,16,19,29,33,123
495800,1,9,10,14,17,29,35,115
495803,1,4,7,17,22,26,31,108
495874,9,10,18,19,22,24,25,127
495914,8,9,14,20,21,24,25,121
495961,6,7,8,11,19,25,27,103
496084,2,6,8,11,21,25,30,103
496103,1,5,11,18,26,32,34,127
496155,5,9,11,16,17,27,34,119
496187,5,8,16,18,22,25,33,127
496240,1,3,7,14,17,27,32,101
496394,1,5,11,18,23,27,28,113
496753,1,5,10,16,24,27,29,112
497051,1,5,15,20,26,27,30,124
497308,6,7,11,17,27,30,34,132
497382,5,9,17,18,19,23,30,121
497565,3,9,15,18,19,29,32,125
497997,4,7,8,13,17,27,33,109
498090,7,8,10,18,24,29,33,129
498393,1,7,8,12,22,25,33,108
498422,4,8,15,16,23,29,33,128
498482,7,12,16,20,26,27,29,137
498633,1,7,9,24,27,31,32,131
498730,1,3,7,11,22,30,35,109
498885,8,9,16,17,22,23,27,122
498998,4,7,15,16,21,25,27,115
499043,4,8,15,19,25,29,33,133
499108,9,14,18,20,23,27,35,146
499316,4,8,10,18,21,23,27,111
499353,1,14,16,20,21,25,32,129
499379,4,5,9,14,23,25,31,111
499402,7,14,15,16,22,26,29,129
499490,2,12,17,20,26,29,33,139
499512,4,12,18,19,21,23,27,124
500234,4,5,10,20,21,25,29,114
500411,3,9,17,24,25,28,32,138
500653,7,9,18,19,22,24,31,130
500736,5,6,11,16,26,27,31,122
500806,5,9,11,17,22,32,35,131
500909,1,4,15,16,25,29,35,125
500926,3,7,14,24,27,31,33,139
501048,1,4,17,20,26,30,33,131
501154,3,5,11,20,24,26,29,118
501255,4,7,17,20,23,24,28,123
501407,3,7,8,24,27,28,33,130
501434,7,10,17,24,27,28,33,146
501793,7,8,11,14,17,27,34,118
501861,7,8,16,17,21,27,34,130
501889,6,8,9,12,29,31,35,130
502360,6,10,15,16,17,24,29,117
502465,4,7,9,13,17,24,35,109
502526,4,8,9,13,19,24,31,108
502760,4,7,8,14,27,28,29,117
502851,7,9,15,17,19,24,32,123
502930,3,6,7,16,22,26,27,107
502989,5,6,9,20,26,29,30,125
503287,2,4,14,18,21,27,35,121
503326,9,12,14,20,27,28,31,141
503546,1,4,18,20,21,25,27,116
503724,5,7,14,20,24,27,32,129
503838,1,14,18,19,25,29,33,139
503953,8,9,18,19,25,29,33,141
504108,2,6,16,17,22,23,31,117
504333,5,6,11,20,21,30,34,127
504347,2,9,17,18,21,23,28,118
504412,1,5,11,16,25,26,27,111
504516,8,9,14,24,25,31,35,146
504622,9,10,17,20,21,29,35,141
504799,8,9,14,17,22,25,29,124
504862,4,12,17,18,25,29,34,139
505006,1,8,18,19,23,29,33,131
505269,7,12,14,16,21,27,29,126
505386,1,7,16,20,21,29,33,127
505856,2,7,11,14,27,29,35,125
506014,7,9,14,17,24,30,34,135
506061,9,14,18,19,22,25,28,135
506196,5,14,15,18,24,25,33,134
506219,9,14,15,20,24,32,33,147
506355,4,7,11,17,22,27,28,116
506449,7,9,17,24,25,28,34,144
506509,3,4,17,18,24,31,35,132
506753,2,4,17,18,21,25,27,114
506893,5,9,11,18,21,27,32,123
507031,4,8,9,14,19,25,27,106
507348,1,8,11,18,22,24,33,117
507391,4,5,9,12,21,27,35,113
507445,7,8,11,13,26,27,34,126
507632,6,7,11,17,22,26,31,120
507715,6,8,17,20,26,31,35,143
507765,7,9,11,20,21,26,35,129
507836,4,12,17,18,23,27,35,136
507873,9,12,15,16,19,29,30,130
507883,2,6,16,18,21,23,29,115
508084,2,4,15,16,21,25,27,110
508260,6,9,11,13,24,26,30,119
508660,9,10,11,16,17,25,29,117
508665,2,3,18,20,26,29,33,131
508717,4,7,14,20,24,25,29,123
508862,5,8,17,18,21,26,32,127
509086,3,6,9,20,21,24,34,117
509973,2,4,16,19,27,31,33,132
510096,2,12,16,17,23,24,27,121
510458,2,8,11,20,21,25,34,121
510557,2,7,16,19,25,26,29,124
511035,2,4,9,13,17,29,35,109
511528,4,8,11,13,21,27,28,112
511670,3,10,11,16,22,26,35,123
511856,7,8,11,17,27,30,35,135
511926,7,9,14,18,23,29,32,132
512386,1,8,16,17,21,26,27,116
512400,6,7,16,17,23,27,31,127
512513,3,14,16,18,24,29,33,137
512567,7,9,15,19,24,30,31,135
512742,9,10,11,13,17,23,30,113
512743,4,12,18,19,22,23,33,131
512836,3,10,16,17,21,27,28,122
512911,5,9,11,14,24,25,29,117
512962,6,9,18,20,26,29,33,141
513096,1,4,14,18,22,27,33,119
513191,1,7,15,19,24,25,30,121
513357,1,5,11,13,22,26,31,109
513556,1,9,15,19,22,24,25,115
514373,5,9,14,20,23,29,35,135
514420,2,7,8,11,22,28,31,109
514578,6,7,16,19,22,26,27,123
514751,7,8,11,18,22,28,35,129
514835,5,9,16,17,21,27,32,127
514949,1,7,17,19,22,23,30,119
514985,3,6,7,19,24,25,27,111
515091,6,9,14,17,29,31,35,141
515126,3,6,7,17,26,27,33,119
515129,7,8,10,14,22,31,35,127
515526,3,9,16,19,23,29,30,129
515547,4,9,10,11,21,25,28,108
515715,2,4,7,19,21,25,31,109
515850,2,7,11,17,26,27,29,119
515851,3,7,16,18,19,24,27,114
515862,1,9,15,18,19,24,28,114
515962,1,5,15,16,23,29,32,121
516099,4,6,10,16,17,27,33,113
516268,4,12,15,19,22,25,31,128
516360,3,9,17,18,22,24,30,123
516417,7,10,11,20,26,29,34,137
516437,4,8,10,11,26,27,35,121
516447,5,14,18,24,25,26,29,141
516454,4,7,10,18,21,23,27,110
516464,1,7,15,19,22,30,34,128
516539,2,4,17,18,19,25,29,114
516656,1,5,16,20,22,27,35,126
516664,7,9,14,20,23,27,30,130
516734,2,4,10,11,21,25,35,108
516876,1,7,10,20,24,25,32,119
517012,9,10,14,16,21,24,31,125
517016,3,5,9,18,19,29,32,115
517122,1,6,16,19,22,26,31,121
517178,4,12,15,19,22,29,35,136
517521,7,10,15,20,26,27,31,136
517610,1,7,18,20,22,31,35,134
517615,9,14,18,19,22,23,28,133
517771,4,8,9,11,21,25,27,105
518071,4,9,11,19,23,25,32,123
518227,1,4,14,18,24,25,29,115
518251,4,7,17,18,21,24,25,116
518458,7,10,14,20,29,30,31,141
518480,1,7,17,18,22,25,35,125
518604,5,14,16,18,23,29,32,137
519162,8,12,15,16,21,26,29,127
519223,2,7,8,17,27,31,32,124
519287,4,5,18,20,21,24,25,117
519469,9,12,15,19,22,25,31,133
519489,6,9,11,16,19,23,29,113
519503,6,7,9,14,23,27,29,115
519681,1,4,18,19,25,28,32,127
520105,5,9,15,20,26,28,29,132
520162,5,9,18,24,25,26,33,140
520550,4,6,10,11,17,25,27,100
520559,2,9,14,20,27,30,31,133
520579,1,10,16,24,27,28,31,137
520589,1,5,7,14,22,25,31,105
520708,7,10,11,17,26,27,34,132
520927,1,4,8,16,27,30,33,119
520977,7,10,17,20,24,30,31,139
521189,7,8,15,24,27,30,31,142
522166,7,12,18,20,21,27,31,136
522291,3,9,10,20,21,25,27,115
522346,5,10,11,14,27,32,35,134
522838,1,14,15,20,27,31,33,141
522898,2,7,17,18,21,24,34,123
523387,5,7,17,20,21,27,34,131
523564,3,7,9,11,24,26,34,114
523675,2,8,9,13,17,27,30,106
523710,1,7,15,20,22,24,32,121
523779,2,3,10,11,21,25,31,103
523897,4,8,10,20,21,23,29,115
524085,7,9,17,20,24,30,32,139
524507,4,9,14,18,29,31,35,140
524550,8,9,14,18,23,29,35,136
524564,4,6,7,17,23,27,32,116
524567,1,7,15,18,19,28,29,117
524843,5,9,17,20,26,29,32,138
525174,3,7,9,11,19,28,34,111
525237,9,12,17,24,25,28,34,149
525436,8,9,15,19,22,25,29,127
525537,5,7,16,19,22,25,29,123
525657,2,7,11,16,22,26,29,113
525749,7,12,17,19,21,27,34,137
526028,1,5,16,18,24,31,34,129
526041,6,7,9,11,23,26,32,114
526080,4,9,17,18,21,26,27,122
526082,4,5,9,14,17,29,35,113
526094,5,7,11,16,17,27,34,117
526507,1,7,16,24,27,30,31,136
526510,1,4,7,12,23,27,31,105
526539,2,7,11,17,23,25,28,113
526856,1,5,11,20,22,24,25,108
526995,4,10,11,18,21,27,31,122
527108,4,12,18,19,29,32,33,147
527110,1,7,8,11,23,27,32,109
527142,7,9,17,18,24,25,28,128
527382,2,7,10,17,23,29,33,121
527413,1,7,14,18,22,32,35,129
527512,1,5,11,16,26,27,29,115
527518,7,9,14,24,25,28,34,141
527647,4,7,18,19,23,29,33,133
527772,1,7,17,18,23,26,30,122
527954,1,10,17,20,21,26,29,124
528151,5,8,9,19,24,25,28,118
528188,7,10,11,14,17,27,32,118
528205,7,10,14,18,24,25,31,129
528247,2,8,16,17,25,27,31,126
528542,1,4,7,11,22,28,33,106
528869,3,6,9,14,23,25,29,109
529027,5,9,17,18,22,24,30,125
529074,1,7,15,24,25,28,32,132
529247,4,7,14,24,27,31,33,140
529509,2,8,17,20,23,26,27,123
529943,2,7,18,24,26,27,31,135
529984,6,7,11,20,21,27,29,121
529993,7,10,11,18,19,25,31,121
530167,1,7,16,18,22,24,31,119
530323,2,10,16,17,21,24,25,115
530422,5,7,16,18,19,25,29,119
530493,6,8,9,19,25,29,35,131
530580,4,6,14,18,23,25,29,119
531399,4,12,14,18,27,31,35,141
531478,8,9,14,20,24,29,33,137
531649,4,14,18,19,25,29,30,139
531809,5,7,17,20,22,26,31,128
531905,1,7,8,11,22,23,30,102
532121,5,12,16,20,21,27,30,131
532158,2,8,9,20,25,29,31,124
532164,1,7,11,18,27,29,34,127
532239,5,8,11,18,23,27,29,121
532293,7,9,17,18,22,23,28,124
532441,7,9,17,20,23,24,27,127
532678,7,9,10,19,23,29,32,129
533173,2,9,17,20,21,23,31,123
533238,3,7,18,20,21,27,31,127
533357,6,9,17,18,29,31,35,145
533390,8,9,14,18,22,25,29,125
533566,2,6,10,11,17,27,35,108
533632,2,14,18,20,25,31,33,143
533698,1,7,10,20,24,25,35,122
533886,7,9,10,11,17,30,34,118
533896,4,9,10,14,21,25,27,110
533914,2,5,11,17,25,28,29,117
533947,5,8,11,20,22,24,35,125
534011,6,9,11,20,26,30,31,133
534208,1,10,16,18,22,23,25,115
534290,5,14,16,18,22,23,29,127
534346,5,14,16,20,24,27,35,141
534407,7,9,17,19,24,28,30,134
534512,2,7,17,18,23,24,27,118
534521,2,4,9,13,19,27,32,106
534560,1,14,15,18,21,29,33,131
534930,4,10,16,18,19,29,33,129
534943,9,12,16,17,23,27,31,135
534973,7,10,11,24,26,27,32,137
535033,7,9,11,14,24,26,32,123
535042,2,8,11,13,29,32,33,128
535208,7,8,14,18,19,28,29,123
535731,2,10,15,18,21,29,33,128
535799,3,4,9,11,21,25,34,107
535851,1,6,7,16,23,24,27,104
535892,8,9,17,18,21,29,35,137
535903,2,4,10,19,23,29,35,122
536346,5,9,16,19,22,28,29,128
536564,5,9,16,17,22,27,29,125
536846,1,7,14,18,27,29,35,131
536902,7,8,15,20,26,27,31,134
537085,1,5,7,20,21,26,29,109
537173,1,4,15,19,25,26,33,123
537759,3,4,14,18,24,27,35,125
538097,2,6,17,20,24,27,33,129
538188,8,9,10,20,26,31,35,139
538358,1,4,10,20,25,27,29,116
538557,7,9,10,16,17,27,31,117
538732,4,12,14,16,25,27,33,131
538748,4,8,9,20,27,28,33,129
538813,3,7,17,18,24,29,34,132
538898,1,5,7,11,27,28,34,113
539241,6,12,14,20,23,27,33,135
539247,2,3,16,19,23,28,29,120
539386,8,9,15,18,21,25,29,125
539405,5,10,16,19,22,25,29,126
539475,1,7,9,18,22,24,29,110
539537,1,7,9,14,23,24,28,106
539541,4,9,15,18,19,27,32,124
539704,1,4,9,13,21,28,34,110
539742,7,10,11,14,22,28,29,121
539888,2,8,9,13,17,29,31,109
540227,4,6,15,17,25,29,31,127
540784,2,6,16,17,23,27,31,122
540826,1,5,8,16,21,24,27,102
541221,4,6,15,19,24,25,28,121
541316,5,8,9,13,21,24,27,107
541599,7,8,17,19,23,24,27,125
541615,2,12,16,17,23,26,29,125
541663,1,7,10,13,22,26,27,106
541736,3,5,16,20,23,26,29,122
541745,2,7,8,14,25,29,35,120
541785,6,12,15,16,17,24,27,117
541899,2,8,14,17,25,29,33,128
542008,7,8,9,18,19,23,29,113
542152,6,8,9,14,25,29,31,122
542259,1,9,17,20,21,23,28,119
542434,1,7,11,14,21,27,34,115
542694,9,10,11,13,17,23,34,117
542903,3,7,8,13,22,24,35,112
543012,3,14,16,17,23,27,32,132
543040,1,7,10,14,27,29,34,122
543134,2,6,10,16,19,27,29,109
543278,1,4,8,13,19,27,29,101
543312,2,8,9,13,17,31,34,114
543580,7,8,11,13,22,27,34,122
543662,2,7,8,19,23,24,34,117
543684,9,14,17,20,27,31,32,150
544006,1,5,11,18,27,30,31,123
544563,6,7,18,19,23,29,31,133
544688,8,9,10,14,27,29,35,132
544718,7,8,11,20,22,28,31,127
544956,6,10,15,24,26,29,35,145
544978,7,8,9,20,21,27,31,123
544979,4,7,10,19,24,27,28,119
545205,8,9,11,16,17,23,27,111
545233,2,4,14,16,25,29,31,121
545245,4,7,17,18,21,23,34,124
545269,3,9,14,18,19,29,32,124
545482,7,8,11,17,22,24,28,117
545720,5,7,11,19,22,25,32,121
545779,4,5,9,14,19,25,29,105
545821,5,8,16,17,22,29,33,130
545832,5,7,8,19,22,23,29,113
545835,8,9,15,20,25,29,32,138
545848,5,9,11,13,17,26,34,115
546059,4,10,17,20,21,25,31,128
546224,2,14,16,17,21,26,27,123
546502,4,8,14,18,29,31,35,139
546537,5,7,9,13,26,29,30,119
546549,7,9,15,19,22,26,29,127
546577,7,14,15,19,21,24,27,127
546606,3,7,16,20,26,27,30,129
546752,5,9,14,20,21,31,33,133
546989,4,8,15,24,25,31,33,140
547014,4,10,18,19,22,31,33,137
547144,1,6,17,18,21,26,27,116
547423,1,6,7,16,25,27,29,111
547566,1,4,15,19,25,27,32,123
547675,3,9,14,18,24,30,31,129
547711,5,14,17,20,22,24,33,135
547770,3,7,9,18,24,26,34,121
548061,5,12,15,19,25,26,29,131
548225,6,7,18,19,23,29,32,134
548530,6,7,9,11,26,32,34,125
548560,1,5,15,16,21,26,29,113
548635,6,7,17,24,27,30,31,142
548841,5,8,15,18,23,29,33,131
548898,7,8,11,14,23,27,28,118
548963,8,9,11,12,19,25,28,112
549023,1,7,10,20,23,27,35,123
549221,4,6,16,17,23,27,31,124
549450,5,8,9,11,25,32,35,125
549556,7,8,17,18,21,23,28,122
549703,4,5,10,13,22,26,31,111
549962,1,14,16,20,21,27,28,127
550227,2,10,11,14,17,26,35,115
550263,1,9,11,18,22,23,29,113
550290,9,14,18,19,23,24,27,134
550292,2,10,11,16,21,25,28,113
551033,1,3,7,18,21,29,34,113
551565,6,7,9,17,24,28,34,125
551681,2,5,8,16,23,24,27,105
551744,4,5,9,12,26,29,35,120
551903,5,6,14,20,27,29,33,134
552084,3,12,14,16,17,23,27,112
552183,4,7,11,16,21,27,28,114
552202,3,9,14,18,22,28,35,129
552308,1,5,7,18,22,29,32,114
552337,5,9,16,17,21,26,27,121
552456,2,7,11,19,25,32,33,129
552714,3,9,17,18,21,30,31,129
552722,4,10,11,14,22,25,27,113
553651,1,7,9,11,23,30,32,113
553705,4,12,17,19,23,27,35,137
554104,3,10,14,16,22,31,33,129
554189,2,4,15,18,21,25,33,118
554206,1,6,14,20,21,25,33,120
554312,8,9,17,18,22,28,35,137
554534,4,6,7,17,23,26,27,110
554634,5,7,11,14,22,23,32,114
554786,3,14,16,20,27,31,35,146
554787,8,9,14,16,22,23,27,119
555030,2,8,16,17,21,28,29,121
555113,4,10,15,19,25,31,34,138
555376,2,7,11,13,17,25,34,109
555385,4,5,8,18,21,27,32,115
555458,9,12,15,17,25,29,34,141
555546,1,5,16,20,22,25,27,116
555694,2,7,8,11,22,23,33,106
555764,3,8,11,20,22,26,33,123
555896,2,7,11,17,21,27,30,115
556230,3,7,17,20,23,24,27,121
556466,1,7,17,18,22,24,27,116
556528,8,9,11,20,24,29,30,131
556584,2,4,7,17,23,31,35,119
556809,3,5,7,20,24,26,29,114
556853,9,14,18,19,24,27,30,141
557154,4,7,10,14,21,23,27,106
557166,3,4,7,20,26,28,29,117
557414,10,14,15,20,27,28,33,147
557447,8,9,17,18,19,23,35,129
557631,1,4,9,18,19,23,29,103
557653,4,8,14,20,25,29,35,135
557681,6,7,14,18,29,30,35,139
557862,8,9,10,16,21,24,25,113
557984,3,7,17,20,26,30,31,134
558069,1,7,9,17,21,26,28,109
558290,10,12,16,19,22,25,29,133
558302,3,4,9,17,25,29,30,117
558363,2,5,11,13,22,26,33,112
558528,2,9,14,20,23,27,33,128
558543,7,8,9,13,27,29,32,125
559102,2,6,17,18,19,27,33,122
559199,1,7,8,20,25,29,32,122
559290,1,10,16,20,25,27,32,131
559547,7,9,16,20,24,26,33,135
559692,1,3,7,16,22,31,34,114
559793,5,14,16,17,21,25,27,125
559798,4,6,17,18,23,26,27,121
559804,3,5,7,19,22,24,30,110
559869,1,9,18,20,26,27,31,132
560006,3,7,9,17,22,27,34,119
560307,1,5,9,18,22,25,28,108
560376,1,7,8,14,27,29,33,119
560454,5,9,11,13,19,24,30,111
560513,7,8,11,17,27,30,34,134
560590,5,9,11,24,26,32,35,142
560651,1,3,8,20,26,29,30,117
560722,2,6,11,17,19,25,29,109
560729,7,12,18,20,21,25,34,137
560741,2,6,9,20,21,27,35,120
560788,1,3,7,14,27,29,32,113
561105,3,9,18,20,21,25,35,131
561727,2,7,8,11,25,29,34,116
561877,4,9,10,16,26,27,31,123
561942,3,4,9,16,17,27,31,107
562156,4,10,11,13,22,26,33,119
562345,7,10,11,19,22,25,28,122
562397,2,12,16,17,24,29,35,135
562588,3,8,9,13,24,29,31,117
562686,1,6,9,24,26,30,35,131
562835,7,9,17,20,24,30,34,141
562942,2,9,11,18,21,27,31,119
562994,4,9,16,17,22,23,27,118
563198,3,7,9,20,23,26,31,119
563243,9,14,17,18,22,23,35,138
563302,5,8,11,20,25,29,30,128
563388,6,7,17,18,22,24,29,123
563547,9,14,15,20,24,25,34,141
563855,2,6,11,20,23,26,29,117
563936,10,14,15,16,26,29,31,141
564096,6,9,17,18,21,27,31,129
564251,3,7,17,18,23,25,32,125
564349,6,8,15,16,23,29,33,130
564546,2,10,16,20,21,23,29,121
564580,4,9,10,12,21,31,35,122
564675,7,10,17,20,23,25,29,131
564803,3,7,10,19,22,25,27,113
565249,7,8,11,14,22,29,35,126
565354,2,9,10,14,17,25,31,108
565410,2,6,15,20,21,27,33,124
565539,1,10,11,17,22,31,35,127
565645,4,7,11,17,22,27,32,120
565657,1,5,11,20,22,30,33,122
565753,3,7,17,18,19,25,30,119
565891,1,9,16,20,21,26,35,128
566045,10,14,18,20,23,27,33,145
566221,9,14,18,20,21,31,34,147
566316,1,12,16,20,22,31,33,135
566353,4,12,17,18,29,32,33,145
566427,4,9,10,11,26,30,35,125
566464,7,12,17,18,22,26,33,135
566574,6,9,14,20,24,25,35,133
566687,6,7,17,19,21,27,28,125
566699,3,7,16,17,22,23,31,119
566754,1,6,16,19,22,23,28,115
566769,8,9,15,17,21,24,35,129
566865,1,7,11,18,21,24,25,107
566876,1,5,16,20,21,27,30,120
566950,4,8,18,19,27,30,33,139
567076,4,8,17,20,25,30,31,135
567126,1,7,11,18,21,27,32,117
567297,5,9,11,18,26,28,29,126
567323,2,9,11,12,17,25,29,105
567471,1,7,11,14,22,28,31,114
567493,3,8,9,12,24,29,35,120
567544,1,12,15,16,21,29,31,125
567547,7,8,9,12,23,29,32,120
567558,9,14,16,20,23,27,35,144
567668,7,8,10,14,17,27,32,115
567696,1,5,10,20,26,27,33,122
567784,4,5,16,17,21,27,31,121
567820,2,8,11,13,21,25,35,115
567883,2,6,7,11,17,30,31,104
568266,7,8,11,18,23,29,31,127
568392,1,12,16,20,22,25,27,123
568743,3,14,16,20,23,27,29,132
569069,7,12,14,20,21,24,25,123
569214,1,5,7,20,25,29,34,121
569803,1,5,11,18,19,29,32,115
569866,2,4,11,17,22,25,29,110
569987,2,7,18,24,26,29,33,139
569990,1,14,15,20,24,26,29,129
570380,2,4,7,11,17,28,35,104
570547,2,9,18,19,22,27,28,125
570578,2,8,11,16,24,29,33,123
570609,5,9,10,20,26,31,35,136
570725,1,9,16,24,25,26,30,131
570820,2,8,16,17,19,23,27,112
571135,3,7,8,14,17,24,27,100
571360,3,9,14,20,27,29,33,135
571367,9,10,16,17,23,29,33,137
571568,6,7,14,20,21,24,27,119
571645,7,14,18,20,22,27,29,137
571997,4,5,16,19,23,25,27,119
572035,10,12,16,17,25,27,32,139
572036,4,8,15,16,29,30,35,137
572095,2,4,8,19,27,29,35,124
572148,7,8,11,18,22,23,29,118
572181,9,12,16,17,24,25,30,133
572208,1,7,11,18,25,30,32,124
572510,1,8,11,19,22,23,25,109
572722,1,6,7,18,22,27,28,109
572815,6,12,15,16,26,29,33,137
572853,1,5,7,16,17,27,34,107
572934,3,14,18,24,26,29,33,147
573018,3,5,14,20,22,29,33,126
573197,3,9,17,20,24,30,34,137
573325,1,7,11,20,25,26,30,120
573429,2,7,8,11,17,28,34,107
573504,5,9,14,17,24,29,35,133
573708,3,9,10,13,17,24,25,101
573766,5,12,14,20,29,32,33,145
573867,2,6,9,18,21,24,31,111
573875,4,6,9,11,19,25,29,103
573898,4,9,10,13,17,28,31,112
574072,7,12,16,17,22,26,31,131
574159,4,7,15,19,23,26,29,123
574209,2,8,11,12,19,25,29,106
574366,1,12,16,18,22,29,31,129
574901,4,9,14,18,23,24,31,123
575061,7,9,10,16,26,29,30,127
575119,4,9,14,20,23,31,35,136
575125,6,7,11,17,27,29,32,129
575159,2,8,16,19,27,29,33,134
575203,2,7,17,20,27,29,33,135
575376,4,9,15,16,19,26,29,118
575488,5,8,11,16,21,23,27,111
575552,4,8,11,13,21,27,29,113
575863,4,6,7,14,23,27,33,114
575882,8,12,14,16,27,29,35,141
575904,4,12,17,18,23,31,35,140
576156,2,7,8,12,17,29,32,107
576161,5,7,11,20,21,26,27,117
576274,1,8,9,14,17,25,29,103
576642,7,8,10,18,23,24,27,117
576973,4,8,14,16,19,27,35,123
577821,1,4,8,20,21,26,29,109
577876,1,5,15,16,21,29,32,119
577994,7,9,11,18,21,24,27,117
578063,3,7,16,19,22,24,34,125
578162,1,7,10,13,17,27,34,109
578172,5,9,10,14,24,25,31,118
578554,1,3,7,16,22,26,30,105
578780,3,7,17,20,22,28,31,128
579162,4,14,18,19,21,25,30,131
579185,2,6,17,18,23,25,33,124
579470,7,8,17,18,24,28,29,131
579485,1,5,8,11,25,27,34,111
579639,4,8,15,17,21,31,35,131
579768,1,6,7,11,22,26,32,105
579841,5,9,14,18,24,27,34,131
580019,1,3,14,20,22,26,33,119
580163,2,7,8,11,21,29,35,113
580190,6,9,15,18,19,24,35,126
580308,4,9,11,13,19,28,32,116
580561,1,8,11,20,23,27,33,123
580601,7,12,14,16,22,31,35,137
580734,6,8,15,20,23,29,33,134
580788,1,9,10,20,25,29,35,129
580876,1,9,11,20,22,28,32,123
580877,1,10,16,20,22,23,27,119
580945,1,4,15,16,21,25,35,117
580958,2,9,15,20,24,26,35,131
580985,6,10,11,16,17,26,27,113
581148,2,8,11,14,21,25,34,115
581348,1,5,11,19,22,25,30,113
581367,5,8,16,24,27,30,31,141
581816,2,7,8,11,19,25,28,100
581901,2,7,17,20,23,27,34,130
581944,3,9,17,18,22,25,30,124
582278,1,4,16,17,23,27,33,121
582484,3,6,9,20,24,26,29,117
582689,2,6,17,20,21,26,29,121
582715,1,7,16,18,22,25,31,120
582771,6,8,16,17,21,27,33,128
582820,7,8,9,14,17,31,35,121
583192,2,8,9,13,24,25,34,115
583361,2,4,15,19,23,29,35,127
583796,2,3,17,20,24,26,31,123
583999,4,12,15,18,19,27,32,127
584023,4,7,9,14,25,29,35,123
584253,7,14,17,18,27,31,33,147
584259,4,5,10,17,27,31,35,129
584410,3,10,14,20,26,29,35,137
584432,1,9,18,24,27,28,35,142
584642,4,8,15,18,27,31,33,136
584868,8,9,10,12,19,29,35,122
585021,3,6,9,13,19,24,29,103
585024,5,10,16,20,21,27,30,129
585138,8,12,17,18,21,26,27,129
585244,2,7,10,11,17,23,32,102
585296,3,9,10,13,17,26,31,109
585324,8,10,11,14,17,27,35,122
585547,4,8,11,16,22,27,31,119
585627,6,7,11,12,26,27,34,123
585655,3,7,10,13,26,27,29,115
585700,4,14,17,20,23,31,35,144
586122,9,14,16,20,25,26,27,137
586290,6,7,9,20,26,27,30,125
586394,1,14,16,20,23,29,33,136
586486,3,7,15,16,22,26,31,120
586502,8,9,15,20,24,29,30,135
586504,5,14,16,18,27,29,33,142
586623,1,3,16,18,23,29,33,123
586923,3,7,9,14,21,24,33,111
587234,1,9,10,19,22,25,29,115
587345,1,4,18,19,23,24,29,118
587357,3,9,16,19,25,29,32,133
587459,9,14,17,18,23,30,33,144
587463,1,3,7,16,22,24,29,102
587494,3,9,11,16,19,30,34,122
587523,5,8,11,13,17,24,27,105
587574,1,12,15,16,22,26,31,123
587673,4,8,9,20,21,26,29,117
587676,6,12,16,17,22,25,27,125
587917,4,9,17,18,21,24,25,118
587921,4,7,15,19,29,32,35,141
587992,2,5,11,14,21,25,34,112
588143,1,9,16,20,22,28,33,129
588418,4,14,16,17,19,23,27,120
588453,8,14,15,20,29,31,33,150
588565,2,9,10,16,26,29,33,125
588900,5,7,16,17,21,27,30,123
588955,6,10,16,20,21,25,27,125
588960,2,4,11,13,21,27,31,109
588973,1,5,9,18,24,25,27,109
589018,2,3,16,17,25,29,31,123
589059,8,9,14,18,22,25,27,123
589060,1,9,18,20,24,27,33,132
589106,1,5,7,20,25,26,31,115
589124,6,8,9,13,25,29,35,125
589198,1,5,11,20,22,28,32,119
589363,2,6,11,16,19,25,30,109
589401,2,5,11,19,23,25,30,115
589458,5,6,16,19,23,27,29,125
589681,1,10,15,16,24,29,33,128
589705,7,10,11,12,17,27,30,114
589793,1,7,11,19,22,29,34,123
589814,5,7,9,13,21,24,30,109
589874,3,9,18,19,22,30,35,136
589888,3,7,9,17,22,27,30,115
590433,8,9,15,18,22,29,30,131
590474,3,9,14,18,24,27,28,123
590762,4,10,17,18,21,28,29,127
590896,2,7,14,20,25,27,31,126
590959,9,10,11,16,19,23,34,122
590979,1,9,16,20,26,29,34,135
591006,8,9,15,18,22,29,33,134
591103,3,9,17,18,21,30,32,130
591158,1,5,11,14,22,25,33,111
591275,5,6,18,19,25,29,33,135
591319,1,7,17,19,22,26,34,126
591565,7,14,16,19,22,26,27,131
591943,3,7,9,19,24,28,29,119
591989,6,9,16,18,19,25,29,122
592003,4,5,9,11,25,26,34,114
592305,6,10,17,20,27,29,33,142
592318,8,9,10,14,25,29,30,125
592372,5,7,11,12,24,26,27,112
592407,6,7,8,11,21,27,35,115
592435,7,9,15,19,22,24,33,129
592595,7,14,17,18,21,24,35,136
592605,8,9,11,13,24,25,31,121
592784,5,9,17,18,22,23,29,123
592818,5,10,17,20,23,24,33,132
593020,1,12,14,18,29,31,33,138
593235,7,8,11,14,25,27,30,122
593273,2,7,16,17,21,25,31,119
593365,4,9,11,13,17,29,32,115
593904,3,6,8,13,17,27,33,107
594076,6,10,11,18,21,27,35,128
594419,2,7,15,17,21,30,31,123
594429,7,12,16,17,19,25,27,123
594522,1,4,10,11,23,27,35,111
594786,2,4,8,16,25,29,35,119
594890,5,7,14,20,23,27,32,128
594912,1,6,16,17,22,27,31,120
595111,4,6,15,20,21,24,27,117
595303,5,12,14,16,27,29,33,136
595597,3,8,11,20,22,26,27,117
595987,5,12,14,16,22,29,33,131
596003,1,5,14,20,26,27,28,121
596110,4,8,15,18,21,29,31,126
596181,7,12,14,24,27,30,31,145
596194,6,9,17,20,26,29,33,140
596213,2,4,10,13,17,24,33,103
596398,4,8,14,17,25,27,29,124
596752,2,7,17,18,21,27,34,126
596814,4,14,18,19,25,26,35,141
596966,2,4,8,20,21,23,27,105
596971,5,9,11,14,25,28,29,121
597065,5,9,14,20,24,25,33,130
597068,2,7,14,16,22,23,27,111
597094,1,7,18,20,22,27,29,124
597415,9,12,17,20,21,24,27,130
597424,1,14,16,17,22,26,33,129
597728,2,7,11,17,25,31,32,125
597785,1,12,17,18,22,27,33,130
597797,3,14,16,17,21,23,27,121
597804,2,5,7,20,25,26,29,114
597846,7,10,14,16,22,29,35,133
597868,3,7,8,16,22,29,30,115
598331,5,6,9,24,26,29,35,134
598356,1,4,9,13,22,23,29,101
598714,6,7,14,20,21,25,27,120
599006,4,14,15,24,25,29,35,146
599096,6,10,17,20,26,27,29,135
599455,6,7,11,19,22,24,28,117
599511,2,5,17,20,22,26,27,119
600065,3,4,9,13,17,28,31,105
600294,1,5,17,20,21,26,34,124
600339,3,7,14,20,27,30,32,133
600534,2,6,16,17,23,27,28,119
600537,1,7,11,16,26,27,35,123
600592,6,9,11,13,17,24,28,108
600623,6,7,9,11,17,28,35,113
600689,2,6,11,19,25,28,34,125
600753,4,9,16,17,22,26,27,121
600797,3,7,14,24,27,30,32,137
601022,7,10,11,17,27,30,31,133
601237,4,7,15,19,24,25,29,123
601242,3,5,10,16,17,27,31,109
601323,4,7,17,20,21,24,27,120
601324,2,5,8,24,25,29,33,126
601495,7,8,9,24,26,29,30,133
601613,5,8,9,11,17,30,35,115
601881,1,7,8,18,24,29,33,120
601888,4,7,9,13,19,24,25,101
601928,3,7,9,20,21,27,30,117
601943,1,7,8,11,22,28,29,106
602370,6,7,11,17,22,25,30,118
602694,6,9,10,11,17,25,35,113
603066,1,10,16,20,23,28,29,127
603172,1,9,17,18,22,23,34,124
603186,7,9,11,17,24,27,30,125
603329,1,4,10,14,25,27,28,109
603416,10,14,16,20,27,29,31,147
603661,6,14,17,18,23,25,33,136
603807,4,6,15,19,25,28,29,126
603950,1,5,8,20,26,29,33,122
604016,1,3,7,20,22,25,27,105
604072,7,8,9,13,23,24,33,117
604264,3,7,8,20,26,27,34,125
604384,3,12,17,20,24,26,29,131
604746,1,3,9,18,22,26,34,113
605030,1,7,11,18,19,27,34,117
605093,2,5,9,18,19,24,32,109
605261,2,7,8,18,23,29,33,120
605379,2,9,16,17,21,24,30,119
605393,2,8,9,13,24,31,33,120
605398,1,9,16,20,24,26,27,123
605973,2,9,17,20,23,24,25,120
606092,5,12,16,17,22,28,29,129
606220,1,6,16,20,22,25,31,121
606348,3,4,14,20,29,30,33,133
606523,1,5,16,17,22,26,34,121
606559,2,6,7,11,21,28,34,109
606804,8,9,10,14,25,28,29,123
606864,3,4,14,20,21,24,25,111
607013,9,14,17,18,24,25,30,137
607060,4,12,17,20,21,26,29,129
607215,1,5,7,12,22,23,35,105
607401,3,9,15,18,19,24,27,115
607474,5,6,10,16,17,27,34,115
607600,2,7,8,17,21,24,29,108
607751,1,9,15,20,22,26,31,124
607754,5,9,10,16,17,23,29,109
607996,5,12,14,20,26,27,31,135
608019,1,12,18,19,26,29,30,135
608123,6,7,9,11,17,30,33,113
608199,4,8,10,17,27,32,35,133
608412,5,10,16,19,22,27,31,130
608447,2,7,14,16,22,29,33,123
608972,7,10,16,20,21,31,34,139
609018,1,5,7,20,26,27,29,115
609032,5,7,8,20,25,29,35,129
609387,8,9,15,24,25,26,29,136
609503,8,9,11,13,22,27,33,123
609515,4,8,15,16,25,31,33,132
609625,1,7,8,18,22,31,33,120
609711,9,12,16,19,22,29,34,141
609883,3,12,15,16,17,23,27,113
610065,2,7,8,17,21,24,34,113
610166,1,7,11,17,24,27,32,119
610596,4,5,7,11,22,26,31,106
610638,1,7,14,20,26,29,33,130
611078,2,10,11,17,22,31,35,128
611137,4,8,9,18,27,31,33,130
611431,7,8,14,20,25,27,31,132
611743,3,10,15,20,24,26,27,125
611865,9,14,17,18,21,24,28,131
612423,7,8,16,20,25,30,31,137
612456,4,6,16,17,19,23,27,112
612999,6,8,9,13,23,29,32,120
613070,1,5,15,20,26,29,31,127
613157,8,10,11,14,25,27,31,126
613355,9,12,14,19,25,29,32,140
613519,3,7,9,16,17,27,30,109
613598,3,8,9,20,24,29,32,125
613650,2,9,15,19,22,25,29,121
613835,7,14,17,20,27,30,31,146
614025,6,7,14,20,29,30,33,139
614200,1,5,9,20,24,30,35,124
614215,4,6,7,19,27,31,33,127
614242,5,6,9,16,19,24,30,109
614382,3,6,7,17,21,27,30,111
614499,4,10,11,16,23,26,27,117
614651,5,8,9,18,19,24,34,117
614937,5,8,16,20,27,31,33,140
614999,1,3,11,20,25,26,30,116
615090,3,4,8,18,27,32,33,125
615208,4,7,9,13,22,26,31,112
615292,5,7,15,17,22,24,28,118
615307,7,8,14,18,23,28,29,127
615337,1,7,9,11,17,26,34,105
615648,6,7,9,11,17,24,30,104
615804,2,5,9,19,25,28,29,117
615896,1,7,10,11,22,25,35,111
616265,1,7,11,17,24,27,34,121
616305,6,7,18,19,23,26,29,128
616350,1,4,16,19,22,31,35,128
616390,1,7,16,17,22,26,33,122
616429,2,7,11,17,26,29,33,125
616570,2,14,18,20,21,25,33,133
616695,9,14,16,20,22,23,29,133
616705,1,7,9,13,17,26,28,101
616933,6,9,10,20,26,29,31,131
617263,2,10,11,17,21,24,25,110
617309,2,6,14,16,27,29,35,129
617315,1,3,11,18,22,28,30,113
617338,1,6,17,18,27,31,33,133
617461,5,9,14,20,26,27,35,136
617484,8,9,17,18,25,27,31,135
617550,1,5,14,16,22,24,33,115
617578,4,5,8,13,21,27,30,108
617786,5,10,11,17,22,26,35,126
617821,4,7,17,18,21,27,34,128
617839,7,14,18,19,24,27,34,143
617850,5,7,11,16,26,27,35,127
617860,4,12,16,20,21,27,31,131
618329,4,10,14,19,22,29,35,133
618416,2,5,16,19,22,26,29,119
618425,7,8,15,24,25,31,35,145
618446,3,9,14,17,26,31,35,135
618682,1,9,14,20,23,27,34,128
618761,1,3,16,18,22,27,34,121
618825,2,7,15,19,23,24,29,119
618963,2,8,11,13,17,27,30,108
619285,5,9,14,20,22,30,31,131
619299,9,12,14,18,24,27,33,137
619330,2,7,10,17,21,27,35,119
619686,7,14,16,18,24,25,27,131
619689,4,7,8,20,23,24,29,115
619695,3,7,18,19,22,23,28,120
619755,8,14,18,19,25,29,33,146
619819,6,8,9,14,29,31,35,132
619890,1,7,9,18,24,28,32,119
620173,4,8,11,20,23,27,33,126
620369,5,7,8,11,26,27,33,117
620450,1,7,15,16,24,27,28,118
620520,1,10,17,20,21,23,33,125
620629,3,14,16,20,21,27,30,131
620672,4,5,17,18,24,28,33,129
620729,3,7,8,18,21,29,35,121
620785,1,3,7,16,22,24,28,101
620823,8,9,16,20,24,27,33,137
621094,9,10,11,14,22,28,35,129
621563,1,5,15,16,22,26,29,114
621602,1,12,14,16,22,31,33,129
621766,8,9,15,17,24,25,28,126
621899,5,9,18,24,26,28,29,139
622087,4,8,9,20,29,30,35,135
622210,9,14,17,18,21,29,35,143
622223,3,7,9,18,19,24,27,107
622478,5,8,16,20,21,27,32,129
622508,2,10,11,13,21,25,27,109
622661,4,5,16,17,23,24,27,116
622797,7,8,14,20,25,29,32,135
622816,1,5,9,16,22,23,32,108
622821,5,9,15,20,21,24,32,126
622825,3,9,16,17,26,30,31,132
623106,3,4,10,12,21,25,27,102
623149,1,6,10,11,21,25,27,101
623189,1,7,17,20,24,32,35,136
623281,1,4,7,20,21,25,28,106
623294,2,8,17,18,21,29,33,128
623378,1,7,14,20,23,27,30,122
623387,1,4,10,18,22,23,33,111
623697,7,12,17,19,23,27,34,139
623910,7,10,17,20,21,29,35,139
623913,1,3,7,24,27,28,34,124
623969,5,12,16,20,21,23,29,126
624096,2,7,8,13,23,25,29,107
624100,2,8,10,13,22,29,33,117
624258,1,12,16,18,23,29,30,129
624411,1,3,7,12,22,28,29,102
624428,3,9,17,18,21,25,32,125
624515,4,7,9,20,26,30,31,127
624643,7,8,11,14,21,27,34,122
624735,5,10,11,20,21,25,30,122
624903,7,8,9,14,21,24,28,111
624905,5,6,9,12,17,31,35,115
625037,9,10,16,17,21,29,33,135
625206,4,10,16,18,19,27,31,125
625551,7,14,18,19,24,26,29,137
625872,2,7,8,19,25,27,29,117
625876,5,7,14,20,24,29,32,131
626013,2,7,11,14,17,30,31,112
626069,2,7,14,18,24,25,27,117
626245,1,7,14,17,22,26,29,116
626366,1,7,8,11,22,24,30,103
626437,3,4,14,18,23,28,29,119
626456,1,3,8,16,22,26,27,103
626550,7,12,16,19,22,31,34,141
626613,5,8,16,18,21,24,25,117
626758,1,3,9,16,22,31,35,117
626809,2,8,16,17,19,27,31,120
626880,1,7,8,24,27,28,30,125
626932,5,9,18,24,26,32,33,147
627296,2,3,7,18,19,24,34,107
627313,2,9,17,18,23,27,32,128
627618,5,10,16,19,22,23,27,122
628049,9,14,15,20,25,29,34,146
628255,6,7,11,12,19,27,28,110
628597,9,14,17,18,19,25,33,135
628730,7,10,14,17,22,23,27,120
628783,2,9,11,13,19,28,29,111
628965,5,10,17,18,21,24,33,128
629103,5,9,10,16,21,24,34,119
629267,7,8,10,14,22,25,27,113
629297,9,10,16,19,23,24,28,129
629444,4,5,14,18,25,29,35,130
629495,5,12,17,18,22,26,35,135
629511,8,12,18,19,22,27,33,139
629524,9,14,16,20,22,23,31,135
629618,4,7,10,18,21,23,25,108
629701,6,7,11,17,22,27,28,118
629703,5,9,11,19,24,28,35,131
629875,5,6,7,17,22,23,27,107
629921,6,9,14,16,22,27,31,125
629979,4,5,18,19,25,28,29,128
630173,1,7,8,13,22,26,35,112
630245,1,10,14,16,22,27,33,123
630334,1,7,9,11,22,25,30,105
630392,1,8,9,12,22,25,28,105
630532,2,6,7,12,21,29,33,110
630735,1,3,7,16,24,27,30,108
630749,9,10,16,19,26,29,30,139
630834,2,7,11,17,21,26,29,113
630842,10,14,16,20,25,27,33,145
631083,5,9,16,20,26,31,35,142
631187,1,6,15,16,23,29,33,123
631222,1,5,9,19,24,30,35,123
631331,1,14,16,20,29,30,35,145
632322,7,8,11,20,23,25,31,125
632462,6,7,11,17,27,32,34,134
632740,4,7,8,14,17,23,27,100
632858,1,4,15,24,25,29,30,128
632965,1,7,11,17,22,32,33,123
633132,7,10,17,19,23,27,30,133
633533,6,7,10,13,17,27,31,111
633771,4,9,16,19,22,29,33,132
633777,4,9,14,20,25,29,30,131
633853,7,10,14,20,21,23,27,122
633936,1,5,7,11,22,25,34,105
634183,3,4,7,17,21,24,27,103
634587,1,12,18,19,26,29,33,138
634692,6,7,8,13,22,27,31,114
634736,9,10,15,24,26,31,35,150
634764,4,6,10,16,21,27,29,113
635002,4,5,18,19,24,25,28,123
635187,1,10,16,20,29,31,33,140
635265,2,4,11,19,25,28,32,121
635409,7,9,18,24,26,28,31,143
635598,5,9,10,16,21,29,35,125
635686,5,12,14,18,27,29,33,138
635700,7,14,17,18,24,27,31,138
635776,1,14,15,16,22,26,29,123
635855,5,9,11,14,25,28,30,122
636069,6,9,17,18,22,23,31,126
636297,7,14,16,20,27,28,31,143
636299,8,14,16,18,21,29,33,139
636418,3,7,18,20,26,27,30,131
636421,2,7,11,17,26,28,29,120
636449,5,10,11,18,21,25,28,118
636672,1,10,16,20,22,25,27,121
636725,4,7,8,16,22,25,27,109
636757,1,9,14,20,22,26,31,123
637422,1,7,11,18,22,25,33,117
637496,6,9,10,13,17,24,30,109
637786,7,8,14,17,21,23,27,117
637883,6,14,15,18,23,26,29,131
638130,2,8,11,13,17,23,28,102
638360,1,3,7,20,23,26,27,107
638373,4,9,14,18,25,31,34,135
638432,1,5,14,20,27,32,33,132
638440,4,6,8,16,21,27,35,117
638694,4,6,10,18,19,25,33,115
638892,9,10,16,17,23,27,30,132
638910,4,12,14,18,21,25,31,125
638926,6,12,15,16,17,29,30,125
638932,1,7,9,11,22,26,29,105
638974,10,12,16,19,24,27,31,139
639159,9,12,15,16,21,23,29,125
639495,4,9,17,18,19,23,31,121
639522,1,9,14,18,24,27,29,122
639532,8,12,15,16,23,29,34,137
639761,5,12,16,19,22,25,27,126
639981,2,7,8,24,29,31,35,136
640084,5,7,8,14,23,27,29,113
640123,6,9,17,18,22,24,25,121
640482,3,12,16,20,23,26,27,127
640736,4,7,8,18,24,27,33,121
640900,1,4,16,19,22,26,35,123
641025,1,5,14,20,26,27,33,126
641071,1,7,9,13,22,32,33,117
641241,4,7,8,11,25,27,33,115
641329,2,3,10,20,23,26,27,111
641681,3,9,14,16,21,25,29,117
641711,8,9,11,17,26,30,35,136
641856,4,5,14,20,25,31,35,134
641912,4,7,11,14,17,27,28,108
641937,2,5,11,20,26,29,33,126
641985,7,8,9,13,19,29,34,119
642064,1,7,9,20,25,29,32,123
642429,6,7,18,19,22,25,29,126
642922,2,9,14,17,21,25,31,119
642965,1,3,16,19,22,26,34,121
643564,8,14,17,18,25,29,33,144
643570,6,8,11,16,27,29,33,130
643734,4,12,15,16,19,29,35,130
643767,5,8,11,16,19,27,31,117
643993,4,9,15,20,26,27,31,132
644106,9,10,14,24,25,30,33,145
644506,9,10,15,18,25,26,29,132
644619,1,7,11,16,22,26,27,110
644631,5,8,11,16,27,31,33,131
644902,9,12,15,16,19,29,32,132
645226,1,7,11,20,24,30,34,127
645374,7,8,14,18,27,29,31,134
645399,1,3,7,17,27,30,32,117
645555,1,7,17,20,24,32,33,134
645594,2,7,11,12,17,30,31,110
646240,2,10,16,17,24,29,33,131
646574,3,5,7,11,22,26,32,106
646723,3,5,10,20,22,26,29,115
646796,8,14,16,20,23,27,35,143
646798,5,6,9,11,22,26,35,114
647261,2,7,8,20,23,27,33,120
647394,3,14,17,18,24,26,33,135
647421,1,12,16,18,22,27,29,125
647456,1,7,17,18,26,30,32,131
647722,9,14,15,20,24,29,34,145
647739,5,9,18,20,26,29,31,138
647749,5,7,9,13,24,26,34,118
647760,3,6,7,12,22,26,31,107
647869,7,9,11,19,26,28,34,134
647904,1,7,11,16,22,24,35,116
648148,6,10,14,20,25,31,33,139
648268,3,7,8,17,23,24,27,109
648292,2,8,11,18,25,29,34,127
648609,7,14,17,18,19,27,33,135
648691,3,4,16,20,21,24,27,115
648695,7,8,10,11,21,27,30,114
648704,4,9,17,20,25,27,31,133
648740,3,7,15,17,24,26,32,124
648830,1,7,18,20,27,31,35,139
648837,6,7,17,19,23,27,30,129
649006,4,9,10,13,21,31,35,123
649071,2,7,11,17,25,26,33,121
649163,2,8,14,16,29,31,33,133
649210,7,12,15,18,22,26,29,129
649529,2,9,17,20,21,27,33,129
649609,7,14,17,18,23,26,32,137
649645,1,4,10,13,22,23,27,100
649646,5,9,14,18,21,27,29,123
649670,3,9,14,24,29,31,35,145
649774,9,10,14,20,23,31,32,139
649891,2,7,17,18,23,25,27,119
649955,5,9,18,19,22,25,34,132
650202,4,5,17,18,23,27,35,129
650313,8,9,17,18,21,24,35,132
650354,4,9,11,24,26,30,35,139
650520,1,3,7,12,22,24,34,103
650532,1,9,17,18,22,28,31,126
650535,5,8,9,14,23,24,35,118
650650,7,8,11,12,21,27,30,116
650745,3,5,16,20,24,26,27,121
650969,4,7,18,19,21,23,25,117
651093,6,10,11,16,26,27,33,129
651322,5,9,17,19,24,25,32,131
651824,9,14,16,18,24,25,31,137
651886,4,8,9,16,21,25,27,110
652195,1,4,11,16,21,25,27,105
652208,1,7,9,20,24,31,32,124
652465,4,9,15,18,19,24,27,116
652482,7,8,9,20,25,26,29,124
652640,1,4,7,20,25,31,35,123
652673,3,12,16,17,27,32,33,140
652842,7,9,14,24,26,29,30,139
653056,4,14,18,20,23,25,27,131
653173,6,7,10,12,17,27,29,108
653235,1,7,8,18,22,24,33,113
653266,1,4,7,14,17,27,31,101
653295,1,5,7,16,22,24,31,106
653331,9,10,15,16,19,24,25,118
653574,1,7,11,12,22,26,27,106
653704,4,9,10,13,17,25,27,105
653782,3,9,14,19,24,25,28,122
653825,2,7,15,17,21,24,34,120
653966,9,10,11,13,19,32,34,128
654103,1,6,14,16,27,29,33,126
654157,2,8,11,17,21,23,35,117
654162,1,5,8,20,26,27,28,115
654199,3,7,9,13,21,24,28,105
654248,10,12,16,19,22,27,31,137
654261,2,14,16,20,23,27,33,135
654263,1,8,16,20,25,27,31,128
654708,3,4,18,19,21,25,29,119
654766,4,7,8,18,21,27,30,115
654876,2,6,17,18,27,29,33,132
654888,8,9,11,13,27,30,33,131
655180,3,7,9,12,26,29,32,118
655191,5,10,14,20,22,27,33,131
655214,2,8,9,13,24,25,31,112
655231,2,7,14,18,24,27,35,127
655580,5,7,8,20,26,27,30,123
655664,9,14,15,16,17,31,35,137
655669,4,9,17,20,21,27,32,130
655741,9,14,16,17,21,27,29,133
655770,1,4,17,18,22,25,31,118
656209,5,9,18,20,23,26,34,135
656647,7,8,14,18,26,27,29,129
656649,1,5,9,20,21,24,27,107
656862,1,3,7,20,21,30,34,116
657331,2,7,17,20,21,27,33,127
657389,9,10,11,14,17,29,35,125
657423,1,3,15,16,24,30,34,123
657512,9,10,11,13,26,30,32,131
657720,6,8,17,20,21,26,31,129
657892,7,14,15,18,24,25,31,134
657969,2,10,11,17,23,27,35,125
657996,2,7,8,11,25,27,34,114
658050,4,8,15,18,21,25,33,124
658250,1,5,7,20,22,23,34,112
658328,2,7,17,19,23,26,29,123
658382,4,7,9,18,19,23,29,109
658538,7,9,14,18,24,30,33,135
658878,3,5,9,16,21,24,28,106
658929,7,10,14,17,21,24,27,120
658969,9,14,15,16,25,29,32,140
658992,3,9,17,18,29,30,34,140
659413,8,9,15,20,24,28,33,137
659439,5,7,17,18,24,31,35,137
659607,7,9,10,13,24,26,35,124
659620,1,4,17,18,24,28,29,121
659680,4,12,17,18,23,25,27,126
659710,4,8,18,24,25,29,33,141
659735,4,14,15,18,21,27,31,130
659829,4,6,16,17,22,25,29,119
660005,1,12,16,18,22,25,33,127
660131,2,6,11,12,19,29,35,114
660289,3,6,7,17,23,27,32,115
660644,1,5,11,17,22,28,35,119
660699,6,7,11,14,24,27,33,122
660734,3,7,9,18,19,24,25,105
660838,3,7,9,18,26,29,35,127
661040,2,9,16,20,26,29,33,135
661152,1,9,16,18,22,31,32,129
661344,5,14,16,20,27,28,31,141
662402,1,7,9,18,22,27,28,112
662678,1,5,17,18,23,26,33,123
662679,5,8,11,20,22,26,31,123
662724,7,14,18,20,23,27,28,137
662734,1,3,9,13,22,26,35,109
662774,3,7,9,16,21,24,30,110
662775,7,8,11,17,24,26,27,120
663012,4,8,15,20,25,27,33,132
663028,2,10,11,17,22,26,35,123
663071,3,4,14,20,23,27,34,125
663213,1,7,15,24,26,27,31,131
663328,1,4,10,16,22,27,31,111
663365,7,9,14,20,22,26,29,127
663456,1,7,11,20,23,30,34,126
663660,10,14,16,20,25,29,35,149
663729,8,9,11,18,22,23,28,119
663822,7,9,11,19,25,26,28,125
663944,1,7,18,19,22,28,33,128
664111,3,10,17,20,24,26,31,131
664218,3,7,14,20,24,25,30,123
664329,6,7,14,20,23,24,27,121
664427,7,8,9,13,21,29,30,117
664573,2,3,16,19,24,25,28,117
664648,5,8,9,11,22,24,35,114
664853,5,9,16,20,24,26,35,135
665175,5,7,9,20,23,26,31,121
665295,2,6,10,16,17,25,29,105
665492,5,7,8,20,24,26,27,117
665541,3,4,15,19,25,29,34,129
665565,3,7,9,12,19,24,27,101
665572,7,8,11,17,26,27,29,125
665578,4,6,8,18,19,25,35,115
665702,3,7,11,18,19,25,34,117
666013,3,7,15,24,26,27,30,132
666052,1,4,17,18,19,23,28,110
666096,1,3,11,20,22,24,30,111
666411,9,12,17,18,22,25,29,132
666457,4,8,15,16,21,23,29,116
666994,5,7,8,18,22,24,29,113
667090,1,3,10,20,26,29,33,122
667114,4,5,8,18,23,24,27,109
667572,4,5,17,20,29,31,35,141
667983,5,14,18,20,25,32,33,147
668009,2,4,8,13,26,27,31,111
668138,5,9,11,17,22,28,35,127
668510,6,7,14,20,21,25,29,122
668552,1,9,18,20,23,27,33,131
668765,3,7,9,18,22,26,34,119
668783,4,14,16,18,23,25,29,129
669030,2,7,8,11,21,26,34,109
669121,9,12,16,17,24,30,31,139
669131,2,6,9,17,23,24,35,116
669922,6,7,8,12,17,27,30,107
669959,6,10,18,19,24,25,33,135
669978,4,8,9,16,27,30,33,127
670036,2,7,8,17,22,31,35,122
670365,1,5,9,20,26,32,33,126
670421,1,7,11,18,29,30,34,130
670523,9,14,18,19,21,29,35,145
670541,3,7,9,14,22,23,29,107
670719,1,9,14,20,27,28,31,130
670798,1,4,9,13,24,26,32,109
670873,1,5,8,20,26,27,33,120
671069,5,9,11,16,17,25,34,117
671305,9,14,15,20,22,24,35,139
671402,1,7,9,20,23,26,27,113
671518,2,8,11,12,21,25,29,108
671698,1,7,11,13,26,27,34,119
671819,2,9,14,19,29,31,35,139
671821,2,7,17,20,22,26,29,123
671834,1,12,14,18,26,29,33,133
671860,3,4,8,20,21,25,27,108
671896,2,5,7,17,21,24,27,103
671917,3,4,8,16,22,31,33,117
671948,5,6,7,12,22,26,29,107
672052,1,12,16,24,27,29,30,139
672275,1,5,11,18,21,25,32,113
672322,5,9,14,20,27,31,32,138
672778,1,8,17,20,26,29,30,131
672783,2,8,18,20,27,29,33,137
672812,7,9,11,14,21,27,28,117
672922,5,9,11,20,23,26,33,127
672977,2,7,8,13,17,27,29,103
673139,2,7,8,12,23,29,33,114
673146,1,4,7,14,27,28,32,113
673181,1,7,10,20,29,30,34,131
673211,9,14,17,20,23,27,30,140
673232,4,8,17,24,27,29,35,144
673318,9,12,16,17,19,24,30,127
673330,5,8,17,18,21,24,33,126
673338,6,10,11,16,19,23,27,112
673510,4,7,9,16,22,26,27,111
673678,3,6,7,18,21,23,29,107
673760,1,8,16,20,27,31,33,136
674080,6,7,9,13,24,26,30,115
674263,7,10,14,24,25,27,30,137
674418,4,6,9,11,21,25,31,107
674487,3,9,17,18,21,26,35,129
674598,9,14,18,19,23,24,25,132
674861,4,5,9,16,25,26,31,116
674908,6,8,9,13,17,23,31,107
675176,1,7,11,20,22,25,33,119
675189,9,10,14,20,22,23,31,129
675205,7,9,11,16,17,25,34,119
675374,5,9,11,16,19,30,35,125
675846,1,7,11,18,22,24,30,113
676013,8,9,17,19,24,25,29,131
676055,7,8,14,18,23,26,29,125
676722,2,6,9,16,17,27,33,110
676983,1,5,11,20,24,28,29,118
677099,10,14,16,19,27,29,30,145
677360,4,5,8,11,22,31,35,116
677456,3,7,11,14,22,28,33,118
677471,5,8,15,16,22,23,27,116
677583,3,12,14,16,22,23,31,121
677812,1,7,17,18,29,30,33,135
677820,7,9,15,17,24,26,30,128
678003,1,8,11,20,23,27,29,119
678010,4,8,15,24,27,29,35,142
678318,2,14,17,20,21,27,33,134
678709,4,8,10,18,19,27,35,121
678943,9,10,14,17,23,31,35,139
679041,5,12,16,17,21,27,33,131
679082,7,8,18,24,25,27,29,138
679089,8,9,10,13,19,26,29,114
679164,3,9,17,20,26,31,35,141
679187,2,5,11,17,25,29,30,119
679240,7,12,15,18,19,26,29,126
679633,7,9,11,16,21,24,27,115
679888,8,12,18,20,25,31,33,147
680119,8,10,11,20,21,24,27,121
680203,1,7,8,17,22,30,34,119
680233,4,8,10,19,25,26,27,119
680296,3,5,18,24,26,27,28,131
680491,2,9,15,16,19,24,28,113
680515,3,4,15,19,23,24,25,113
680624,6,14,15,16,22,27,31,131
680675,1,4,8,13,21,26,27,100
680896,2,7,9,16,22,26,27,109
680899,4,8,9,14,23,24,35,117
680919,1,4,18,19,22,23,28,115
681076,1,3,7,16,22,30,34,113
681156,2,6,7,19,26,29,35,124
681218,1,4,10,13,23,27,31,109
681333,4,6,11,19,22,25,29,116
681494,1,5,7,12,22,30,32,109
681547,2,6,16,17,19,23,29,112
681754,4,7,11,17,22,24,35,120
681923,4,8,16,17,23,27,28,123
681994,5,7,8,20,23,25,29,117
682054,2,14,16,20,23,29,35,139
682118,4,6,11,17,22,31,35,126
682278,2,6,9,13,19,24,34,107
682407,4,9,14,18,19,25,29,118
682553,1,3,9,12,24,25,29,103
682718,7,9,10,11,17,24,34,112
682838,3,7,8,14,26,27,29,114
682915,7,8,14,18,23,29,35,134
683004,6,10,16,17,27,28,33,137
684544,1,7,11,12,22,24,25,102
684604,1,3,7,20,29,30,34,124
684665,9,12,17,18,26,30,33,145
684692,7,8,9,11,24,30,34,123
684883,8,10,11,18,22,23,29,121
685049,1,3,16,18,23,25,29,115
685242,1,5,18,20,26,27,34,131
685303,1,14,15,20,22,26,27,125
685608,2,7,8,11,29,30,32,119
685643,2,12,16,20,21,27,29,127
685919,6,14,16,19,25,27,29,136
686180,8,9,11,18,22,28,29,125
686212,3,7,18,19,22,23,29,121
686225,1,5,17,20,26,29,31,129
686375,1,5,7,18,29,32,35,127
686396,3,4,11,18,21,24,25,106
686456,4,5,9,14,19,25,31,107
687210,3,12,16,18,21,24,27,121
687363,5,9,17,18,23,31,32,135
687371,1,12,16,17,22,29,34,131
687418,4,6,17,18,21,23,33,122
687574,2,4,14,18,21,27,33,119
687601,7,8,9,13,22,24,25,108
687644,6,12,15,16,17,29,31,126
688012,10,14,16,18,21,29,33,141
688028,4,9,14,18,24,27,35,131
688170,9,12,16,18,19,25,29,128
688268,4,12,16,19,21,27,29,128
688490,6,12,16,19,24,27,33,137
688592,7,8,15,17,21,28,29,125
688594,1,3,7,24,26,27,33,121
688667,9,14,17,20,23,24,30,137
689120,1,7,11,13,22,29,34,117
689188,4,9,11,20,22,26,29,121
689195,3,9,18,20,21,27,31,129
689287,3,7,9,24,25,26,31,125
689325,2,10,16,19,21,23,29,120
689522,9,10,11,13,17,28,31,119
689615,4,7,8,14,21,23,27,104
689655,1,7,11,18,22,27,29,115
689673,1,5,18,20,25,26,31,126
689745,2,6,9,19,21,29,35,121
689900,4,7,16,17,21,24,27,116
689948,5,9,18,19,24,27,35,137
690083,5,14,15,20,25,29,33,141
690131,7,9,17,18,24,28,29,132
690270,3,5,11,16,22,26,35,118
690280,8,9,14,18,23,29,33,134
690453,3,9,10,14,22,27,35,120
690764,4,12,17,18,21,25,32,129
690844,3,10,11,18,21,25,27,115
691093,7,9,11,12,17,28,32,116
691100,2,6,11,19,29,32,35,134
691275,7,9,10,11,17,27,28,109
691290,5,9,17,18,29,30,35,143
691437,8,10,16,20,25,27,29,135
691619,5,9,17,18,24,29,32,134
691624,5,8,17,20,26,27,31,134
691711,1,5,10,20,25,26,31,118
691735,1,7,10,17,27,30,31,123
691968,5,8,9,18,23,24,27,114
692020,1,7,10,11,19,26,27,101
692139,9,14,17,18,23,27,28,136
692524,3,4,17,18,22,23,30,117
692696,2,3,7,14,22,27,33,108
692752,2,7,8,11,19,24,29,100
692810,5,9,11,19,24,25,34,127
692815,8,9,15,18,22,28,31,131
692818,1,6,7,20,24,27,32,117
692874,9,14,17,20,21,29,31,141
692890,9,12,14,16,22,31,33,137
693191,4,8,9,11,17,25,31,105
693319,6,8,11,18,22,25,31,121
693340,9,10,17,18,21,27,30,132
693437,3,4,14,18,21,23,27,110
693538,7,10,14,16,21,27,29,124
693796,1,5,7,17,26,27,30,113
693892,6,10,16,19,22,31,33,137
694053,3,9,10,19,24,25,29,119
694106,3,8,9,14,25,29,34,122
694143,6,8,9,12,17,31,35,118
694447,2,4,8,11,25,32,33,115
694814,5,9,16,20,26,27,32,135
694892,7,8,14,17,23,24,27,120
695045,1,6,9,20,24,30,31,121
695174,3,8,9,18,25,29,30,122
695238,2,7,11,18,19,24,29,110
695288,1,7,11,12,22,27,30,110
695498,4,7,9,13,21,24,29,107
695796,7,12,17,18,22,24,33,133
695808,3,14,17,18,25,26,31,134
695838,2,6,11,13,17,25,29,103
695930,2,3,8,16,23,24,27,103
695941,7,14,18,20,21,29,34,143
696179,2,5,9,18,19,24,25,102
696293,4,8,9,19,25,27,30,122
696468,7,10,11,20,26,28,29,131
696605,4,9,17,20,22,26,31,129
696617,1,7,8,11,22,26,35,110
696853,4,5,8,13,22,23,29,104
696918,3,9,11,20,26,29,30,128
696933,5,8,10,16,25,27,29,120
697034,3,8,9,20,25,26,29,120
697072,2,7,11,12,17,23,30,102
697083,2,6,16,19,23,29,33,128
697296,1,7,9,11,22,24,35,109
697516,2,6,16,19,22,25,27,117
697716,7,9,15,17,23,24,28,123
697811,3,10,14,20,24,29,33,133
697884,2,8,9,24,25,29,30,127
698138,3,14,15,18,22,24,33,129
698221,2,7,8,11,22,25,27,102
698236,1,7,9,17,21,28,32,115
698631,8,9,16,18,24,27,31,133
698671,4,6,9,12,21,25,29,106
698694,7,8,17,20,24,30,35,141
698823,1,14,16,18,24,27,29,129
698867,4,7,17,18,23,27,34,130
699498,5,9,11,16,21,24,30,116
699509,8,9,15,20,23,24,32,131
699578,7,9,17,19,24,26,30,132
699976,7,14,18,20,27,28,29,143
699998,1,5,9,20,23,28,34,120
700079,4,8,9,20,23,29,35,128
700203,5,8,14,18,25,29,33,132
700258,3,7,16,18,19,29,35,127
700299,1,3,14,20,22,26,29,115
700443,6,8,9,11,17,25,29,105
700607,4,9,16,19,25,31,35,139
700779,7,8,9,12,22,29,35,122
700829,1,5,7,16,22,27,31,109
700832,2,7,8,11,25,27,28,108
700858,2,5,10,11,21,25,32,106
701057,3,7,16,17,22,24,30,119
701236,3,6,7,18,19,23,29,105
701318,1,6,9,13,24,30,32,115
701380,1,5,14,18,24,29,33,124
701932,3,7,17,18,26,27,33,131
702037,4,9,10,18,19,23,30,113
702087,7,8,15,17,21,27,30,125
702143,3,8,9,13,24,32,35,124
702359,1,4,10,16,23,27,35,116
702489,5,9,11,20,21,25,30,121
702687,4,8,17,19,22,29,35,134
702737,5,9,16,24,26,32,35,147
702937,1,7,9,11,19,24,30,101
703210,2,5,7,11,17,28,31,101
703263,4,7,9,13,24,26,32,115
703264,4,9,17,18,23,25,29,125
703276,4,7,8,12,17,27,33,108
703344,3,9,16,17,23,27,28,123
703601,2,10,11,14,17,25,30,109
703605,5,9,15,17,22,24,25,117
703727,4,12,17,18,21,24,25,121
703800,6,9,18,19,23,29,34,138
703845,1,14,18,24,29,30,33,149
704119,6,9,17,18,24,31,35,140
704195,2,5,18,20,23,26,27,121
704364,9,10,16,17,27,31,32,142
704380,1,5,11,18,27,30,33,125
704438,4,6,17,18,21,27,30,123
704454,4,9,17,20,21,24,27,122
704534,9,12,14,20,21,25,29,130
704561,1,3,9,18,24,25,29,109
704850,4,7,15,19,22,23,29,119
704854,3,7,11,14,22,25,28,110
705672,7,10,16,17,27,28,32,137
705811,2,10,16,17,26,29,33,133
706007,5,6,11,17,22,31,35,127
706013,10,14,16,20,21,25,27,133
706026,4,5,17,20,27,31,33,137
706091,8,9,15,18,29,31,35,145
706218,2,7,11,17,25,27,28,117
706221,1,7,11,20,24,31,34,128
706271,6,9,10,17,25,27,31,125
706293,1,7,17,24,27,28,34,138
706325,3,5,11,16,22,26,33,116
706482,3,4,16,17,21,27,31,119
707265,1,7,11,18,22,26,27,112
707292,6,7,17,18,23,28,32,131
707613,1,5,9,20,24,28,34,121
707651,1,7,18,24,25,28,35,138
707659,6,7,10,11,21,27,28,110
707684,1,5,7,16,24,27,29,109
707788,3,9,16,20,21,24,27,120
707865,4,8,10,13,21,27,28,111
707879,2,5,11,13,17,27,30,105
708380,1,6,7,17,22,26,31,110
708447,8,12,15,16,21,29,35,136
708480,8,14,17,18,24,27,33,141
708625,7,8,11,14,27,28,30,125
708755,1,7,8,17,23,27,34,117
708890,5,6,9,14,29,31,35,129
709172,4,9,10,11,21,24,25,104
709199,7,8,9,13,24,25,31,117
709275,1,3,9,18,24,27,31,113
709318,9,14,15,20,24,28,29,139
709555,1,7,8,17,21,27,28,109
709610,5,9,11,18,19,24,30,116
709688,8,14,16,18,19,25,29,129
709738,8,10,15,16,23,29,33,134
709762,2,8,15,16,19,24,25,109
710010,2,8,11,19,24,25,28,117
710616,1,5,9,20,24,26,32,117
710760,1,3,7,18,22,32,33,116
711102,1,5,7,14,22,31,34,114
711108,5,8,11,13,22,27,31,117
711164,1,7,9,13,24,26,28,108
711265,2,6,8,13,29,32,33,123
711356,3,7,17,20,26,27,33,133
711372,1,6,9,13,24,29,35,117
711381,2,6,8,16,19,27,29,107
711456,6,10,11,18,19,25,29,118
712124,9,14,15,16,19,29,34,136
712248,1,7,16,19,22,23,31,119
712378,7,10,17,18,27,29,33,141
712413,2,12,16,17,19,23,31,120
712646,3,8,11,14,22,26,35,119
712713,7,9,11,17,22,27,34,127
712717,1,5,11,18,23,28,34,120
712996,1,4,9,16,22,26,27,105
713094,1,7,10,14,22,30,35,119
713202,2,5,9,11,21,32,35,115
713324,8,9,18,24,26,29,33,147
713350,5,6,9,17,19,24,25,105
713594,3,6,9,20,21,24,27,110
713654,9,10,14,19,25,29,33,139
713775,7,9,15,24,26,30,35,146
713776,4,10,18,19,22,25,31,129
713834,3,9,11,17,22,26,35,123
714034,2,9,11,13,17,26,33,111
714158,7,10,11,20,23,26,27,124
714293,4,6,17,20,25,31,35,138
714473,1,10,11,18,22,24,33,119
714505,2,9,11,13,17,32,34,118
714564,9,14,16,17,21,23,27,127
714569,8,9,11,20,23,24,29,124
714724,4,7,10,14,23,27,35,120
714732,6,10,16,19,27,29,30,137
714781,4,7,11,14,26,27,33,122
714793,1,7,15,19,22,27,30,121
714917,5,7,10,17,23,27,34,123
714993,5,7,18,19,21,24,25,119
715126,2,6,7,18,19,25,29,106
715257,1,6,7,11,22,24,32,103
715936,9,12,15,18,19,29,30,132
716096,7,9,11,16,17,26,31,117
716136,2,12,16,17,25,26,31,129
716363,10,14,15,20,22,29,33,143
716383,8,12,15,20,21,27,33,136
716422,1,5,7,20,27,30,33,123
716641,2,9,17,20,23,24,34,129
716890,1,9,16,20,22,24,29,121
716920,7,14,18,20,22,29,33,143
717059,3,5,7,24,26,27,30,122
717205,5,7,9,14,22,28,31,116
717500,1,5,11,18,24,25,29,113
717567,3,8,9,20,24,27,32,123
717625,7,8,11,14,25,27,29,121
717683,1,10,15,20,27,29,33,135
717933,4,7,8,17,23,27,30,116
718047,6,7,11,12,17,27,28,108
718070,2,4,14,16,21,25,27,109
718077,6,7,11,19,22,29,35,129
718260,8,14,16,17,22,27,31,135
718673,4,14,17,18,23,25,33,134
718763,3,6,17,18,22,28,33,127
718890,7,9,11,18,24,26,32,127
719348,2,9,16,20,25,26,31,129
719772,1,5,9,20,23,28,29,115
719925,8,9,10,13,24,30,33,127
719961,1,5,9,20,26,29,34,124
720056,9,12,18,19,23,29,30,140
720205,8,10,11,14,22,25,33,123
720522,4,9,11,17,21,30,35,127
720768,3,7,11,14,24,27,30,116
720812,2,8,16,24,29,31,35,145
720896,1,5,7,17,22,28,33,113
721262,6,9,16,18,19,23,29,120
721437,1,5,9,20,24,26,31,116
721469,3,7,9,18,21,24,27,109
721528,6,9,11,17,21,30,35,129
721558,8,9,18,20,24,27,31,137
721709,3,5,15,20,22,26,29,120
722057,5,7,9,20,24,26,28,119
722163,2,4,18,19,23,29,33,128
722166,8,9,10,14,29,30,35,135
722356,4,5,8,11,25,27,35,115
722379,1,5,15,18,22,27,33,121
722851,4,8,9,14,24,27,35,121
722862,10,14,15,16,24,29,31,139
723053,3,9,14,20,24,25,33,128
723588,1,8,15,16,19,24,25,108
723786,2,4,10,18,21,25,29,109
723831,1,7,17,20,26,28,32,131
723880,3,8,9,18,22,27,35,122
723882,1,6,16,17,27,31,33,131
724024,4,9,14,18,19,24,35,123
724031,1,9,10,13,23,28,29,113
724161,5,6,9,14,24,25,30,113
724602,5,7,16,17,23,24,27,119
724676,6,14,16,18,21,23,29,127
724803,4,6,18,19,25,29,34,135
724869,2,10,11,13,17,26,30,109
725474,2,7,14,17,21,23,27,111
725677,5,7,17,18,21,23,34,125
725869,7,8,10,12,17,27,33,114
726220,1,10,14,16,26,27,29,123
726365,4,5,17,20,21,25,27,119
726472,3,7,18,19,22,25,35,129
726794,7,14,18,20,22,25,33,139
727037,7,9,11,14,17,25,28,111
727242,3,7,11,16,22,26,28,113
727254,8,9,15,18,25,29,32,136
727280,9,14,16,17,23,27,29,135
727284,7,9,16,17,21,24,27,121
727341,4,8,9,18,19,23,25,106
727353,7,8,11,13,27,30,34,130
727377,2,14,15,20,29,31,33,144
727393,2,6,11,16,17,23,35,110
727778,4,14,18,19,25,26,27,133
728295,1,12,17,18,21,26,29,124
728439,1,7,14,20,23,29,33,127
728549,7,9,15,20,21,24,27,123
728838,8,9,16,17,19,23,29,121
728855,4,14,18,20,21,29,31,137
728920,1,5,16,19,22,32,33,128
728944,2,7,11,18,19,25,34,116
729258,2,7,17,24,25,27,31,133
729319,7,10,16,17,19,23,27,119
729530,8,14,17,18,23,31,33,144
729724,5,8,10,20,27,31,33,134
730199,8,9,17,20,24,25,31,134
730447,1,7,10,18,22,27,28,113
730737,1,12,16,20,22,27,33,131
730955,2,9,14,16,27,29,33,130
731021,2,8,9,17,23,25,29,113
731345,4,9,16,17,23,27,28,124
731413,8,9,15,16,19,29,35,131
731555,3,4,9,13,21,29,32,111
731619,8,12,15,16,21,28,29,129
731778,5,7,11,17,27,30,32,129
731909,6,12,17,18,26,29,33,141
731941,4,12,16,17,22,25,27,123
732068,6,7,11,19,25,27,30,125
732429,6,9,11,13,19,24,25,107
732619,5,9,17,20,22,29,35,137
732698,4,7,11,13,26,27,33,121
732755,3,7,9,16,26,29,30,120
732944,3,4,10,17,21,25,27,107
733099,2,7,11,12,17,23,34,106
733164,1,7,17,18,22,27,31,123
733260,2,4,15,20,21,29,33,124
733313,2,5,8,24,25,28,33,125
733317,9,14,15,18,22,31,34,143
733681,4,9,14,18,23,29,35,132
733878,2,7,15,20,26,27,30,127
734084,4,8,17,18,22,23,29,121
734563,4,8,9,20,23,29,30,123
734578,8,14,15,18,21,29,33,138
734706,8,9,10,11,25,31,35,129
734996,4,5,8,20,27,29,33,126
735027,9,14,18,20,22,27,31,141
735056,2,7,9,11,17,30,34,110
735142,3,7,9,14,17,29,30,109
735218,5,8,16,20,29,30,35,143
735294,2,3,14,19,25,29,33,125
735332,2,8,17,19,25,26,29,126
735477,2,7,17,19,25,28,29,127
735536,4,5,17,20,23,24,33,126
735605,7,8,9,16,22,29,33,124
735936,1,5,7,14,22,25,32,106
736139,3,7,9,16,19,24,32,110
736227,1,7,18,20,25,27,29,127
736374,2,10,11,14,23,29,35,124
736752,1,6,7,20,21,25,31,111
736948,3,6,8,18,24,29,33,121
737013,8,14,15,16,27,29,33,142
737209,4,10,18,19,23,25,31,130
737476,1,7,16,17,24,27,28,120
737540,1,12,16,20,21,27,33,130
737756,5,7,11,12,17,27,30,109
738505,6,12,16,18,21,29,35,137
738522,2,4,7,19,24,25,28,109
738786,7,10,17,20,26,27,31,138
738915,4,7,18,19,23,24,34,129
739185,3,7,10,11,21,24,27,103
739337,4,10,11,14,21,27,35,122
739491,3,7,11,17,22,30,35,125
739543,1,5,11,20,21,27,32,117
739745,3,6,17,18,19,23,33,119
739837,3,7,8,14,24,25,27,108
739877,2,3,14,18,24,27,33,121
739913,1,6,15,18,22,27,33,122
740800,4,7,16,17,22,27,31,124
740884,6,8,9,13,23,27,29,115
741037,3,9,17,20,26,27,31,133
741357,6,12,14,20,27,29,33,141
741627,7,12,15,19,22,28,29,132
741764,4,5,10,13,22,26,27,107
742171,8,14,15,20,29,30,33,149
742174,4,9,14,18,23,29,30,127
742505,4,9,16,18,21,27,31,126
742830,5,7,9,17,23,24,30,115
742919,4,6,14,24,25,27,31,131
743225,4,12,18,19,21,24,25,123
743376,2,7,11,14,19,25,30,108
743788,3,7,17,18,24,27,35,131
743973,3,5,7,20,21,27,30,113
744308,4,8,10,16,23,27,29,117
744471,4,9,18,19,21,25,28,124
744498,2,7,10,11,17,28,31,106
744506,8,10,16,20,23,25,29,131
744543,8,12,18,19,23,26,29,135
744677,2,7,11,17,24,28,31,120
744756,1,7,17,18,21,25,30,119
744760,1,4,18,20,23,24,25,115
744800,1,4,18,20,25,31,35,134
744825,5,8,18,19,22,28,33,133
745261,5,7,18,19,24,27,28,128
745344,7,9,11,14,22,29,35,127
745425,2,14,16,18,21,23,29,123
745532,3,4,7,14,25,27,31,111
745542,9,10,14,20,23,26,29,131
745609,1,7,10,14,22,32,35,121
745690,3,7,16,17,22,29,30,124
745779,3,9,11,13,26,30,32,124
745792,3,4,8,16,27,32,33,123
745843,4,7,11,16,17,27,32,114
745892,5,8,9,11,24,25,27,109
746009,2,6,11,16,17,32,35,119
746105,8,9,11,13,17,25,32,115
746211,1,5,11,16,22,30,33,118
746268,1,3,16,20,23,26,29,118
746416,1,4,17,20,21,23,29,115
746465,1,8,15,16,21,24,25,110
746582,5,9,11,18,26,28,33,130
746710,7,10,17,24,27,28,34,147
746711,6,9,14,19,25,29,32,134
746829,4,8,17,18,23,27,30,127
747000,1,7,16,20,22,26,29,121
747419,1,7,10,20,21,24,27,110
747718,3,7,8,18,23,29,35,123
747833,9,14,15,18,24,32,33,145
748056,1,5,7,20,26,31,34,124
748254,7,12,17,18,22,23,31,130
748402,4,8,15,20,23,29,30,129
748541,3,5,11,20,24,26,34,123
748805,5,10,17,20,21,26,31,130
748846,6,8,11,20,25,29,35,134
748866,5,9,16,18,19,24,31,122
749028,3,7,8,20,27,29,33,127
749041,4,6,10,20,21,25,29,115
749048,1,3,7,24,25,27,28,115
749322,3,14,16,17,23,27,29,129
749328,1,7,16,20,22,23,31,120
749428,7,9,10,19,24,30,34,133
749429,4,6,7,12,21,23,27,100
749650,4,6,17,18,19,23,25,112
749953,4,10,17,20,25,27,29,132
750133,3,9,17,18,22,23,33,125
750380,3,8,17,20,27,31,33,139
750729,3,4,16,20,21,26,27,117
750907,5,12,17,18,24,29,33,138
751148,1,7,10,11,23,24,27,103
751317,4,9,10,12,21,25,29,110
751407,6,7,17,18,22,27,28,125
751452,7,9,17,18,22,24,30,127
751612,3,5,16,18,22,26,31,121
751671,3,4,9,20,21,25,31,113
751863,2,4,8,17,25,31,34,121
751938,1,7,11,18,21,26,29,113
751991,5,9,11,13,21,26,34,119
752394,2,7,9,11,21,24,27,101
752435,3,7,16,19,22,23,27,117
752439,4,5,8,20,29,30,35,131
752692,1,3,8,20,23,26,27,108
752818,1,6,14,20,23,26,27,117
753159,1,4,10,18,19,29,33,114
753225,7,8,11,19,22,28,29,124
753234,9,14,18,19,22,28,29,139
753382,5,9,15,18,26,29,33,135
753626,1,7,16,17,21,27,28,117
753644,6,10,17,18,21,23,33,128
753825,3,6,18,24,25,26,29,131
753855,1,5,16,20,23,29,34,128
753904,3,9,14,20,24,29,34,133
754049,1,9,16,18,22,24,29,119
754214,3,9,11,13,24,26,35,121
754559,4,8,14,20,25,27,29,127
754790,7,14,17,18,23,24,28,131
754827,1,7,9,14,29,30,34,124
754982,3,7,17,24,27,30,35,143
755018,9,14,18,20,21,25,34,141
755079,4,8,15,20,23,29,33,132
755456,4,6,8,19,25,27,30,119
755558,3,9,18,20,21,25,28,124
755591,3,4,18,19,25,29,30,128
755686,7,8,9,14,21,29,33,121
755752,9,14,15,18,22,23,35,136
755973,2,8,9,17,21,29,35,121
756068,5,14,16,17,22,23,27,124
756247,2,7,8,11,24,25,28,105
756304,2,7,11,17,22,28,32,119
756365,1,7,16,20,22,25,27,118
756438,9,12,14,20,21,25,31,132
756566,8,10,11,20,27,31,33,140
756708,5,9,11,13,19,26,32,115
757041,5,9,15,16,26,29,34,134
757125,1,5,15,16,22,26,35,120
757158,2,9,11,13,19,28,33,115
757544,10,14,15,16,24,25,33,137
757560,6,7,17,18,21,24,27,120
757590,5,9,11,16,17,23,30,111
757792,4,5,8,18,19,25,27,106
757902,2,9,11,14,17,31,35,119
758091,2,3,7,17,24,25,31,109
758369,1,7,9,11,25,26,28,107
758416,1,7,17,20,21,26,31,123
758864,5,9,11,14,25,26,30,120
759169,1,14,16,20,22,25,35,133
759253,2,8,9,17,25,28,29,118
759295,2,3,9,13,17,29,32,105
759994,9,10,15,16,19,24,33,126
760038,2,8,10,20,23,29,33,125
760053,1,5,16,17,22,25,31,117
760106,4,10,17,20,21,26,29,127
760335,1,6,7,11,17,27,34,103
760542,1,9,15,16,25,28,29,123
760602,3,9,15,16,19,24,28,114
760788,8,9,15,16,24,28,29,129
760890,4,12,15,16,21,29,30,127
760935,7,14,17,20,21,24,31,134
761212,5,9,18,20,26,27,35,140
761241,2,4,8,13,19,27,33,106
761287,1,7,8,18,27,29,31,121
761363,4,7,11,17,21,27,32,119
761934,3,9,11,24,25,26,28,126
761956,8,9,10,13,17,23,31,111
762146,7,12,14,24,25,27,31,140
762345,3,7,15,19,24,27,30,125
762399,6,7,11,17,22,23,33,119
762558,6,7,14,20,22,27,31,127
762562,7,12,14,20,25,26,29,133
762686,2,7,11,19,24,25,35,123
762760,3,5,9,12,26,29,35,119
762875,8,12,16,24,25,27,33,145
762934,2,9,15,20,26,31,35,138
763105,2,4,8,17,25,27,34,117
763114,10,14,16,19,22,25,31,137
763294,1,7,11,17,22,32,34,124
763392,3,9,14,20,24,27,31,128
763396,2,9,10,17,25,31,35,129
763455,4,8,18,19,25,28,31,133
763461,5,9,11,18,19,28,33,123
763545,5,9,11,12,25,26,33,121
763767,2,7,9,11,21,27,28,105
764005,1,5,16,20,25,27,33,127
764117,2,5,9,16,21,29,35,117
764164,1,7,11,18,22,26,34,119
764503,4,6,15,19,25,27,35,131
764543,4,7,9,11,22,26,28,107
764584,1,4,17,20,23,26,30,121
764702,2,6,11,13,26,29,35,122
764706,5,9,17,18,21,24,32,126
764908,1,6,7,18,22,26,31,111
764987,1,7,9,24,26,29,30,126
765336,5,14,16,20,25,28,31,139
765403,7,12,18,19,21,23,29,129
765742,1,6,16,20,22,31,33,129
765985,2,6,9,17,21,25,31,111
766331,3,4,14,20,22,23,27,113
766362,2,12,18,19,22,25,33,131
766527,5,14,16,20,24,25,33,137
767035,1,4,15,20,25,26,30,121
767185,1,5,16,19,22,30,34,127
767279,4,10,15,16,19,27,29,120
767787,1,7,8,11,24,27,29,107
768126,4,7,17,18,21,28,34,129
768402,2,7,8,18,22,29,31,117
768479,2,4,7,18,21,25,31,108
768522,2,7,8,24,27,28,35,131
768670,2,8,11,13,17,24,30,105
768760,7,14,16,20,24,27,29,137
768917,2,8,11,16,27,31,35,130
769745,6,10,17,18,23,24,33,131
770252,4,7,15,16,21,23,27,113
771006,4,14,17,19,25,27,31,137
771169,3,8,9,13,22,29,33,117
771300,6,9,11,13,17,30,32,118
771429,5,14,17,18,26,29,35,144
771574,2,3,9,18,22,26,31,111
771619,1,4,15,19,25,27,28,119
771691,8,10,16,20,25,29,33,141
771836,1,5,7,16,22,25,29,105
771899,2,3,8,16,23,25,29,106
771912,1,5,11,14,25,27,28,111
771945,4,10,14,19,25,27,32,131
772033,1,5,17,20,22,27,33,125
772096,4,9,11,17,22,25,29,117
772357,2,6,10,11,17,25,31,102
772562,7,14,15,19,25,28,29,137
772563,1,7,8,19,22,26,29,112
772597,1,7,15,18,24,25,28,118
772610,3,4,8,13,19,27,32,106
772906,4,7,8,11,17,27,30,104
772992,4,8,10,13,22,25,31,113
773033,7,8,11,20,27,29,35,137
773040,5,9,16,18,21,24,35,128
773066,8,9,16,20,25,26,31,135
773560,9,12,15,19,22,29,35,141
773613,2,7,16,20,21,25,27,118
773784,3,7,9,14,23,24,28,108
773792,9,14,18,19,21,25,29,135
773941,1,7,16,18,22,28,29,121
774254,6,8,16,20,21,23,27,121
774475,7,14,16,18,22,25,33,135
774545,4,7,9,11,17,25,30,103
774573,5,10,14,20,26,29,31,135
774667,5,7,17,18,21,26,27,121
774967,8,9,17,18,22,24,25,123
774971,1,3,17,20,26,27,31,125
774979,4,14,16,20,21,29,31,135
774985,8,9,10,14,23,29,35,128
775608,2,6,11,13,19,29,30,110
775644,8,9,14,24,26,31,35,147
775670,4,5,8,13,19,27,29,105
776046,5,12,16,17,27,31,33,141
776050,1,4,14,18,24,25,33,119
776102,1,5,8,20,25,26,29,114
776207,4,9,18,19,25,28,29,132
776347,8,9,15,24,25,29,34,144
776794,3,5,9,20,24,26,28,115
777096,4,12,14,18,19,27,35,129
777179,7,12,17,18,22,23,35,134
777345,4,14,18,19,24,29,31,139
777447,1,5,7,20,22,26,33,114
777613,4,8,14,16,21,27,29,119
777689,1,9,10,13,17,23,28,101
777852,3,4,9,13,21,27,30,107
777902,5,9,11,17,25,26,28,121
777965,1,7,14,18,22,23,29,114
778018,4,14,15,18,21,27,32,131
778200,5,9,14,20,25,30,31,134
778298,5,9,14,20,23,27,33,131
778485,8,10,15,16,24,25,29,127
778501,5,9,11,18,21,30,31,125
778556,4,5,8,11,26,27,35,116
778716,7,9,18,19,22,29,35,139
778764,7,9,10,11,17,29,34,117
779112,3,4,17,18,21,23,33,119
779162,2,4,7,19,23,27,33,115
779329,5,9,16,20,22,26,29,127
779450,1,4,7,16,22,26,31,107
779550,2,14,18,19,25,29,33,140
779604,5,9,18,24,26,30,33,145
779708,9,12,14,20,25,29,34,143
779834,2,4,8,13,25,31,34,117
779908,9,12,14,19,25,27,29,135
780138,4,8,17,20,23,27,32,131
780276,5,8,9,20,26,30,31,129
780890,2,6,11,20,26,29,35,129
781142,1,6,10,16,22,27,29,111
781212,5,9,15,20,24,26,33,132
781272,1,7,14,18,19,29,30,118
781448,1,8,11,13,22,26,32,113
781709,5,8,9,18,21,27,29,117
782118,4,9,11,13,17,30,32,116
782334,5,8,11,18,22,23,32,119
782362,3,8,9,13,29,30,32,124
782744,8,9,11,12,21,25,27,113
782765,1,4,16,17,21,27,28,114
782911,6,7,11,19,27,28,33,131
782989,2,5,9,20,26,27,35,124
783287,4,6,10,18,19,25,27,109
783312,2,6,8,11,19,25,30,101
783450,1,5,7,19,22,27,30,111
784051,2,4,15,17,19,24,25,106
784310,3,7,9,11,19,24,28,101
784388,6,7,17,18,19,23,30,120
784396,2,7,10,14,23,29,34,119
784873,2,14,15,20,21,29,33,134
785313,2,7,16,20,21,27,31,124
785988,2,7,11,19,24,25,32,120
786709,2,5,7,11,17,30,35,107
786890,9,14,18,20,21,25,28,135
787144,3,9,11,13,24,26,30,116
787468,4,7,8,13,22,26,27,107
787480,7,9,17,20,24,29,35,141
787871,2,6,11,18,21,27,33,118
787934,3,14,15,20,26,29,33,140
788219,1,5,10,20,27,31,33,127
788423,4,7,9,13,19,24,34,110
788617,5,14,18,20,25,28,33,143
789016,4,8,10,19,25,27,35,128
789239,5,8,11,20,24,29,32,129
789375,8,9,15,20,24,27,34,137
789385,3,8,9,13,26,29,31,119
789780,1,7,9,13,22,28,32,112
789787,3,9,18,19,22,26,34,131
789972,6,14,16,18,29,31,35,149
789974,7,10,11,16,19,27,29,119
790328,7,8,18,19,22,27,33,134
790329,5,6,11,14,23,27,35,121
790391,8,12,15,16,24,25,31,131
790541,8,9,14,17,23,25,29,125
790580,3,9,14,20,24,25,34,129
790611,9,10,14,16,23,24,31,127
790617,3,8,9,20,25,29,34,128
790750,2,14,15,18,27,29,33,138
790846,1,9,18,19,23,29,34,133
791043,6,8,9,13,22,29,35,122
791056,4,5,14,20,21,25,29,118
791128,4,14,17,18,25,27,33,138
791142,2,10,11,13,19,23,34,112
791344,4,5,10,14,22,27,35,117
791479,4,7,8,17,22,29,35,122
791584,5,10,11,14,24,25,27,116
791620,1,9,14,20,23,27,33,127
791687,4,8,15,18,26,29,35,135
791741,1,7,18,24,25,29,32,136
792061,1,7,9,14,22,30,34,117
792429,1,6,11,12,27,31,35,123
792577,1,14,16,20,22,27,29,129
792867,1,8,9,12,24,25,30,109
793156,1,7,14,20,23,24,34,123
793162,7,8,16,20,22,23,29,125
793279,4,6,7,17,21,25,27,107
793293,1,8,11,20,21,25,31,117
793344,3,9,18,19,22,23,29,123
793390,2,7,11,17,24,27,29,117
793546,5,9,14,20,22,24,27,121
793710,1,4,7,12,27,31,32,114
793716,4,5,10,13,19,27,31,109
793736,4,10,15,19,26,29,35,138
793787,4,14,15,19,25,31,32,140
793870,2,12,14,16,19,29,35,127
794089,4,7,18,19,23,29,31,131
794287,4,5,15,19,21,24,25,113
794323,3,4,14,18,19,24,25,107
794423,7,9,11,17,21,24,30,119
794483,9,10,14,19,22,24,25,123
794528,1,9,11,18,22,28,35,124
794561,1,5,8,16,22,29,32,113
794890,6,14,16,18,19,25,29,127
795200,2,6,8,16,17,29,31,109
795242,9,12,16,17,27,28,33,142
795446,2,8,9,20,24,25,31,119
795462,2,4,10,14,25,29,35,119
795665,1,7,9,16,22,29,33,117
795984,1,7,8,18,22,25,35,116
796193,2,7,16,17,21,27,32,122
796442,2,4,17,18,23,27,32,123
796671,5,8,16,20,23,28,29,129
796697,1,4,9,18,22,28,31,113
796954,8,9,14,18,21,26,29,125
797315,1,9,10,16,29,30,33,128
797319,3,4,17,18,23,24,28,117
797324,6,14,15,19,25,29,33,141
797358,6,7,11,18,19,25,35,121
797680,9,12,15,16,17,24,27,120
797789,1,4,9,20,25,26,29,114
797811,4,5,17,18,21,23,27,115
797913,1,9,17,18,24,25,28,122
798015,9,12,16,17,24,30,35,143
798075,4,8,11,18,21,24,27,113
798104,3,8,9,20,22,24,29,115
798272,7,14,15,20,25,28,29,138
798421,1,4,17,20,26,30,31,129
798427,3,8,18,19,22,27,33,130
798448,2,3,17,20,25,26,29,122
798487,2,7,9,16,22,26,31,113
798657,5,6,9,18,19,23,29,109
798691,5,8,11,18,24,25,28,119
799196,1,7,17,18,22,23,25,113
799608,1,5,8,16,22,25,33,110
799890,2,6,9,19,24,25,35,120
799902,4,7,11,16,19,25,27,109
800092,8,9,10,18,19,23,29,116
800412,2,6,10,17,25,31,33,124
800441,1,4,10,20,24,25,35,119
800680,5,14,17,18,26,32,35,147
800748,1,5,7,24,27,28,29,121
800953,2,7,10,19,25,29,33,125
800966,4,6,7,20,21,24,27,109
801121,3,7,9,14,17,24,31,105
801262,5,8,11,13,17,27,30,111
801590,8,9,15,20,26,27,30,135
801966,1,14,17,18,23,25,33,131
802067,6,12,15,16,17,25,31,122
802103,5,6,9,11,19,32,35,117
802157,4,12,14,18,29,31,35,143
802221,5,8,14,18,29,32,33,139
802507,9,12,15,20,21,24,34,135
802705,7,9,15,19,23,24,28,125
802986,1,7,15,16,19,26,29,113
803024,1,7,17,19,22,30,34,130
803027,7,8,15,24,25,26,30,135
803148,4,14,18,19,25,27,35,142
803240,1,5,14,16,22,25,33,116
803593,1,9,18,19,22,24,27,120
803597,4,7,16,20,23,26,27,123
803628,3,4,7,13,26,27,31,111
803687,2,7,8,11,19,27,34,108
803690,2,4,17,24,25,28,31,131
803710,4,7,8,20,24,25,31,119
803837,5,10,16,17,21,26,27,122
803921,1,12,16,19,22,24,33,127
803970,4,8,9,18,19,24,29,111
804116,2,7,11,16,17,26,35,114
804158,3,14,18,20,25,32,33,145
804161,2,10,16,17,23,27,31,126
804455,7,8,11,16,22,27,29,120
804571,2,12,14,16,29,31,35,139
804620,1,9,14,20,24,29,32,129
804724,1,9,15,20,23,24,31,123
804801,9,10,14,20,25,29,34,141
804910,5,9,16,19,24,30,33,136
805005,1,4,15,18,22,28,33,121
805027,7,14,17,18,23,25,29,133
805030,7,12,18,20,26,27,31,141
805295,1,3,9,13,24,32,33,115
805391,8,9,11,16,17,28,32,121
805652,4,14,18,20,27,31,35,149
806081,2,6,11,19,25,28,32,123
806363,2,3,11,16,21,25,27,105
806570,4,6,17,18,19,23,33,120
806669,5,8,18,19,23,29,33,135
806692,1,4,9,18,24,28,33,117
806698,2,7,8,20,27,31,32,127
806813,2,9,16,17,23,31,35,133
806823,8,9,17,20,23,24,28,129
807120,4,12,15,20,21,27,31,130
807142,2,14,17,20,25,29,33,140
807247,4,5,8,13,21,24,27,102
807439,6,10,11,17,25,27,35,131
807495,7,8,9,20,26,31,35,136
807527,1,12,16,17,23,24,27,120
807821,1,3,15,20,22,26,32,119
807910,4,5,10,13,17,27,32,108
808804,3,7,11,20,22,26,28,117
808840,2,6,17,18,23,26,33,125
808852,2,7,8,11,23,25,34,110
809340,3,7,17,18,24,30,35,134
809849,5,9,10,13,19,29,32,117
809927,7,8,11,18,24,26,29,123
809961,1,9,16,18,23,29,33,129
809975,4,9,16,17,19,25,29,119
809977,2,4,8,20,21,29,33,117
810359,1,4,8,13,19,27,28,100
810634,6,9,10,16,21,26,29,117
810989,8,9,16,20,27,30,33,143
811127,2,6,10,11,17,25,33,104
811207,2,4,8,13,19,27,35,108
811370,4,9,15,18,19,24,25,114
811469,4,5,9,11,21,26,35,111
811543,4,7,14,18,23,27,29,122
811551,3,6,7,11,26,27,33,113
811606,4,8,11,16,22,29,33,123
811963,1,3,7,18,22,31,33,115
812160,5,14,18,24,25,27,33,146
812229,2,7,8,19,22,23,29,110
812511,6,7,11,17,22,24,29,116
812516,6,10,16,19,22,23,29,125
812562,8,9,11,12,21,27,35,123
812977,2,5,10,13,17,27,33,107
812987,4,14,15,19,21,25,31,129
812996,3,9,14,16,17,29,33,121
813051,2,10,11,17,24,28,35,127
813178,1,8,16,17,23,27,29,121
813184,2,9,11,20,26,31,35,134
813446,5,9,17,19,22,24,25,121
813508,2,8,11,12,22,27,35,117
814064,5,6,7,20,26,27,30,121
814082,1,3,18,24,26,27,31,130
814117,1,3,7,16,22,25,35,109
814170,1,4,7,18,25,27,31,113
814223,6,9,10,17,23,27,35,127
814775,1,4,8,16,22,27,29,107
814814,4,9,16,20,26,27,33,135
814886,1,7,16,20,25,32,33,134
815153,5,9,14,18,24,27,31,128
815203,7,9,14,18,22,24,35,129
815208,7,9,15,19,22,24,29,125
815378,1,5,16,19,22,27,32,122
815458,3,7,9,18,19,24,31,111
815649,2,4,14,19,25,29,34,127
815680,3,5,9,20,24,26,34,121
815701,1,7,17,20,26,30,31,132
815768,6,12,17,18,19,29,33,134
816096,7,12,17,18,22,23,27,126
816381,3,5,9,14,24,25,27,107
816465,5,7,11,20,21,28,34,126
816486,6,7,10,17,21,23,27,111
816719,5,8,11,24,25,27,29,129
816739,1,3,7,14,22,32,34,113
816763,2,9,18,24,25,26,29,133
816818,8,9,18,24,25,28,29,141
816894,5,6,9,18,24,26,29,117
816959,2,7,14,18,24,25,35,125
817188,4,14,18,19,23,29,33,140
817243,9,10,17,20,21,23,31,131
817458,10,12,16,19,27,29,35,148
818130,7,9,11,17,24,27,34,129
818181,2,8,11,20,27,29,33,130
818318,1,4,17,18,22,23,31,116
818338,5,9,17,20,25,31,34,141
818418,1,5,16,17,22,27,33,121
818533,1,7,14,17,24,27,31,121
818647,5,7,11,14,17,26,27,107
818737,7,9,18,24,26,27,28,139
819121,1,6,7,20,22,26,31,113
819212,2,5,15,20,21,29,33,125
819217,4,8,9,19,25,29,31,125
819252,1,7,11,18,23,29,34,123
819388,2,4,8,13,27,28,29,111
819487,3,7,9,24,26,30,33,132
819516,4,7,9,11,24,26,32,113
819797,1,3,9,20,26,30,33,122
819842,2,4,10,17,23,25,29,110
820169,4,6,17,18,29,31,35,140
820310,2,4,17,18,24,29,33,127
820388,4,10,11,19,22,25,29,120
820890,4,8,15,24,25,29,31,136
820964,2,6,9,18,19,24,33,111
821087,1,7,11,18,24,29,30,120
821229,8,14,16,17,23,27,35,140
821345,8,9,15,20,24,28,35,139
821415,1,3,8,16,27,29,33,117
821580,4,5,9,13,19,27,32,109
821709,3,9,14,20,23,27,30,126
822138,4,7,14,16,27,29,33,130
822217,6,10,15,17,26,29,35,138
822443,2,3,17,20,26,29,33,130
822654,7,8,9,13,21,24,29,111
823121,1,10,16,17,23,27,32,126
823172,2,6,11,19,25,28,31,122
823183,4,5,8,20,21,26,27,111
823218,7,9,15,16,19,24,31,121
823611,1,4,7,18,22,24,35,111
824070,4,5,16,17,22,23,27,114
824103,1,8,9,20,23,25,29,115
824114,2,8,9,18,25,29,33,124
824292,3,9,11,13,26,27,30,119
824294,7,8,9,13,19,29,30,115
824680,1,7,16,20,25,27,31,127
824725,3,9,16,17,21,29,34,129
824756,5,8,9,11,23,32,35,123
824863,4,7,11,17,26,27,35,127
824937,7,14,15,20,25,27,29,137
825257,10,14,15,16,21,29,33,138
825361,4,8,11,13,19,27,31,113
825631,2,9,10,19,25,29,33,127
825747,3,9,16,17,24,27,31,127
825926,4,9,10,12,21,24,25,105
826134,3,5,11,18,22,26,29,114
826184,2,6,16,19,23,26,29,121
826196,3,7,9,14,22,26,29,110
826213,3,9,10,13,24,26,34,119
826433,7,9,16,19,21,24,25,121
826609,1,7,16,20,27,28,29,128
826619,4,7,8,16,21,26,27,109
826651,5,8,16,18,27,29,33,136
826810,6,9,15,18,19,24,33,124
826825,2,3,16,19,22,31,35,128
827147,2,8,15,19,26,29,35,134
827242,3,7,9,24,26,29,34,132
827278,1,7,9,13,17,30,34,111
827422,4,6,9,20,26,29,33,127
827476,2,6,15,20,21,26,29,119
827679,2,3,9,18,26,29,33,120
827765,5,14,16,20,24,29,31,139
827768,7,10,11,16,26,27,29,126
827870,9,14,17,20,25,27,29,141
827967,2,6,11,17,25,30,32,123
828040,3,12,17,18,21,27,33,131
828041,5,7,9,24,26,30,35,136
828136,7,12,15,16,17,25,31,123
828495,1,9,18,19,24,28,29,128
828835,5,8,16,17,23,27,29,125
828851,4,8,14,19,22,25,27,119
829006,2,6,14,19,25,26,29,121
829126,4,10,16,19,22,23,29,123
829192,9,14,18,19,24,31,32,147
829220,1,4,14,18,19,29,35,120
829309,2,8,11,20,23,24,27,115
829492,5,9,11,20,21,26,29,121
829637,3,5,9,20,21,29,34,121
829733,3,6,7,20,26,27,30,119
829763,7,9,10,11,17,26,30,110
829841,7,9,14,18,21,24,30,123
830146,4,8,11,14,22,31,35,125
830169,3,4,14,19,22,25,29,116
830288,5,7,8,18,21,24,25,108
830310,6,7,8,19,25,27,29,121
830729,2,4,8,13,24,29,31,111
830887,1,6,7,18,22,25,31,110
831173,4,8,15,18,19,29,35,128
831210,1,9,14,20,23,24,27,118
831427,10,14,15,20,27,31,33,150
831540,4,5,8,18,21,27,33,116
831701,3,8,11,18,25,29,31,125
831713,2,9,17,20,24,30,33,135
831725,3,4,17,18,22,23,35,122
832111,8,12,16,17,23,27,30,133
832142,1,5,16,20,21,26,34,123
832461,2,6,7,11,21,27,28,102
833023,7,8,11,20,27,28,34,135
833199,2,7,8,11,22,31,32,113
833464,3,6,11,20,26,27,30,123
833527,8,9,16,20,22,27,29,131
834219,3,14,16,20,27,31,34,145
834394,8,9,14,18,26,27,29,131
834527,5,9,15,19,24,25,32,129
834567,8,9,10,16,17,27,31,118
834618,1,12,16,20,22,29,31,131
834624,7,9,17,20,24,28,30,135
834738,1,5,7,12,22,24,31,102
834820,4,10,11,16,19,23,27,110
835332,5,6,11,18,26,29,33,128
835452,5,9,16,19,23,26,29,127
835702,3,4,9,13,17,24,33,103
835798,5,9,11,12,25,26,28,116
835941,2,3,7,19,24,30,34,119
836405,5,9,10,16,21,29,34,124
836435,1,7,18,20,23,27,29,125
836681,2,9,10,17,25,27,31,121
836868,2,10,11,14,25,31,34,127
836991,5,7,9,12,24,26,32,115
837177,1,7,9,20,25,28,32,122
837263,9,14,17,18,26,29,35,148
837319,4,10,15,18,19,25,28,119
837389,1,10,16,18,27,29,31,132
837647,9,10,11,13,19,24,35,121
837654,8,10,17,18,21,27,33,134
837749,1,7,18,20,22,29,31,128
837777,1,12,16,17,22,27,35,130
837947,6,7,17,19,22,23,29,123
838189,1,4,18,19,22,28,33,125
838566,2,7,15,20,21,24,27,116
838612,3,4,17,20,25,27,31,127
838734,9,14,18,19,23,27,29,139
838870,5,9,16,24,26,31,32,143
838993,5,6,9,18,19,24,34,115
839016,3,7,9,24,26,27,28,124
839514,6,8,11,13,17,27,32,114
839609,7,12,15,17,21,24,34,130
839741,5,8,9,20,26,29,31,128
839770,2,8,17,18,21,26,33,125
839785,4,9,10,17,21,24,25,110
839815,5,10,17,18,24,29,33,136
840078,2,4,8,18,23,25,33,113
840266,1,5,9,18,24,28,35,120
840322,2,8,9,13,22,27,32,113
840383,1,5,7,19,22,23,30,107
840387,7,8,11,18,19,24,34,121
840745,6,9,16,17,29,31,35,143
841038,7,9,16,20,26,31,34,143
841239,7,10,17,18,22,24,33,131
841619,5,7,14,20,22,24,25,117
841764,10,14,16,17,27,29,34,147
841811,2,12,14,16,19,25,29,117
841877,2,4,18,19,22,25,35,125
841959,4,9,10,13,21,29,32,118
842271,7,8,15,16,21,25,29,121
842345,9,14,16,20,21,23,27,130
842402,4,8,11,17,27,30,35,132
842453,5,8,11,12,19,27,35,117
842483,1,8,18,20,27,29,33,136
842768,3,4,9,18,22,26,35,117
843122,4,10,14,16,21,23,27,115
843402,9,12,17,18,26,29,30,141
843440,4,8,17,18,21,23,34,125
843495,4,12,18,19,22,27,31,133
843670,1,4,16,17,27,29,33,127
843734,4,12,14,18,19,27,33,127
843885,4,5,8,14,22,25,27,105
843923,2,4,15,18,19,24,25,107
844069,8,9,15,20,25,29,30,136
844483,1,8,15,20,22,26,27,119
844568,7,9,16,19,24,25,28,128
845223,6,7,14,20,23,26,27,123
845676,1,10,11,16,27,31,34,130
845701,1,8,11,13,17,27,32,109
845726,1,5,7,13,24,27,34,111
845788,5,8,11,16,22,26,31,119
845813,2,7,8,20,24,25,35,121
845983,1,6,17,20,26,31,35,136
846027,5,9,17,18,21,24,27,121
846113,2,14,16,19,23,29,32,135
846238,9,10,17,18,23,25,29,131
846447,4,10,14,17,22,31,35,133
846510,9,10,15,16,26,29,30,135
846515,4,7,8,11,17,26,27,100
846565,1,7,11,19,22,28,31,119
846722,1,12,16,20,23,26,29,127
846924,3,6,9,13,24,26,27,108
846955,4,8,11,13,17,24,27,104
847021,6,9,15,19,24,25,27,125
847102,4,9,17,20,21,27,31,129
847146,4,8,9,18,24,31,33,127
847185,5,9,11,20,26,30,33,134
847274,3,4,17,20,21,26,27,118
847325,10,14,15,16,17,25,27,124
847348,2,7,8,12,17,31,34,111
847459,1,8,18,20,22,27,33,129
847682,6,9,15,19,22,24,25,120
847947,4,7,16,19,22,27,31,126
848033,1,7,16,18,22,31,34,129
848164,1,7,9,19,22,26,29,113
848178,7,14,15,18,26,29,32,141
848350,7,14,18,19,24,27,28,137
848407,3,8,11,12,19,25,27,105
848593,1,4,7,16,23,27,35,113
848754,3,12,15,18,22,26,27,123
848793,4,5,9,14,25,31,33,121
850239,7,8,9,11,19,25,34,113
850330,7,12,17,20,24,30,33,143
850571,2,6,11,17,22,25,32,115
850583,7,8,14,24,27,31,33,144
850692,1,5,11,20,21,29,34,121
850844,1,7,17,20,21,24,34,124
851026,1,7,15,19,22,26,30,120
851057,7,12,18,19,23,27,29,135
851117,3,7,11,17,22,30,31,121
851132,4,7,9,11,17,28,35,111
851327,1,5,9,18,24,25,29,111
851395,9,12,16,17,22,29,30,135
851815,4,5,10,19,22,31,35,126
851820,5,7,14,18,24,25,28,121
851973,1,7,10,20,24,27,29,118
852061,4,7,15,20,24,26,27,123
852515,2,5,11,13,17,26,32,106
853081,10,14,17,20,24,31,33,149
853368,2,4,10,13,17,29,34,109
853504,2,9,11,13,19,32,33,119
853520,4,7,8,12,23,27,29,110
853545,1,10,17,18,21,26,27,120
853632,1,10,16,19,22,23,28,119
853698,7,10,14,17,27,29,33,137
853705,8,10,15,16,25,29,32,135
853845,6,9,14,20,23,24,31,127
853980,1,3,16,18,27,29,33,127
853981,4,7,15,18,21,25,30,120
854185,1,3,15,20,26,27,30,122
854469,1,4,15,19,29,30,35,133
854553,6,14,17,18,25,31,33,144
854641,2,8,9,18,25,29,32,123
854734,1,3,9,13,22,26,30,104
854956,2,4,11,17,19,31,35,119
855145,4,7,8,14,27,31,33,124
855187,2,7,9,11,26,27,32,114
855410,9,10,18,19,21,25,29,131
855790,9,12,16,17,24,29,30,137
855819,3,7,17,18,25,26,31,127
855964,1,3,9,16,24,28,31,112
856102,1,9,15,18,22,26,35,126
856262,3,14,16,20,25,27,32,137
856509,7,10,18,19,25,29,31,139
856524,7,12,14,18,27,29,35,142
856601,1,3,7,11,27,28,32,109
856684,1,10,16,20,23,26,29,125
856747,3,7,9,12,22,26,31,110
856763,2,3,11,14,19,25,29,103
856841,7,12,17,18,22,24,29,129
856898,2,7,14,20,21,27,31,122
857008,2,4,14,19,25,29,31,124
857102,1,7,11,20,29,31,34,133
857180,7,10,17,20,21,27,28,130
857187,3,4,9,12,26,31,35,120
857272,2,8,14,18,29,31,33,135
857380,6,10,11,17,26,27,35,132
857476,7,9,10,20,21,25,27,119
857541,7,14,16,17,23,27,31,135
857656,5,10,16,20,23,26,27,127
857666,1,4,7,14,23,27,30,106
857679,3,6,11,13,17,27,30,107
857929,1,7,9,20,24,31,34,126
858043,7,8,17,20,23,24,33,132
858302,2,7,8,16,25,29,32,119
858309,6,9,15,17,19,24,35,125
858459,6,7,10,11,26,27,32,119
858584,1,9,14,19,25,29,34,131
858690,7,8,14,17,22,31,35,134
858704,5,9,18,20,21,26,32,131
858737,3,8,17,20,23,29,33,133
858964,1,7,14,20,23,24,25,114
859672,4,9,14,18,22,25,31,123
859674,6,7,10,20,26,29,31,129
859947,5,9,11,16,23,26,27,117
859975,5,7,14,18,24,27,34,129
859998,5,9,11,13,24,26,35,123
860298,7,9,18,19,21,24,28,126
860594,2,8,18,20,27,31,33,139
860662,5,8,9,20,23,29,35,129
860702,2,7,11,17,25,31,34,127
860707,4,7,17,18,23,26,27,122
860762,2,8,11,20,24,29,35,129
860848,4,7,8,17,25,27,33,121
860874,1,5,7,20,23,26,27,109
860957,3,10,16,17,23,27,32,128
860965,3,4,17,20,22,26,27,119
861017,1,9,18,19,22,26,28,123
861134,3,9,18,19,23,24,32,128
861136,1,6,7,11,22,25,28,100
861290,9,14,15,19,23,24,25,129
861536,1,4,8,11,27,29,35,115
861554,7,8,18,20,21,24,27,125
861749,6,7,17,18,22,23,32,125
861793,5,6,9,19,26,29,35,129
862182,4,7,10,14,27,30,31,123
862320,4,7,10,14,25,26,27,113
862536,7,8,16,20,22,27,35,135
862781,1,3,17,20,21,26,31,119
863095,2,7,11,13,21,31,34,119
863289,8,9,11,19,24,25,28,124
863423,9,14,15,17,25,28,29,137
863471,7,8,9,13,24,26,28,115
863571,8,9,10,16,21,25,29,118
863594,2,5,7,11,26,27,30,108
863781,3,4,15,20,21,29,33,125
863803,6,9,10,16,21,29,32,123
863932,4,7,8,17,24,27,33,120
864102,1,4,7,18,22,23,28,103
864244,5,10,14,18,27,29,33,136
864251,5,9,11,20,25,26,34,130
864506,4,5,17,18,21,26,27,118
865128,8,9,11,14,23,25,29,119
865361,2,10,11,19,23,25,28,118
865465,3,4,8,18,24,25,31,113
865560,9,14,16,19,23,29,34,144
865561,9,12,15,16,21,24,29,126
865562,1,12,16,17,21,26,27,120
865782,3,8,17,20,26,29,30,133
865883,3,7,18,20,26,29,34,137
865958,7,12,16,17,22,29,30,133
866118,1,14,16,20,25,28,31,135
866169,4,9,10,13,26,31,34,127
866311,4,8,15,16,21,24,27,115
866345,1,7,10,14,22,27,28,109
866441,7,8,10,17,23,24,27,116
866566,5,9,11,14,22,25,32,118
866592,1,4,17,18,22,23,34,119
866595,8,14,15,16,25,29,35,142
866601,4,5,16,20,21,29,35,130
866771,9,10,18,19,23,29,34,142
866790,1,3,9,13,19,24,34,103
866827,4,12,14,18,25,31,33,137
866955,2,7,15,20,21,27,31,123
866986,3,4,9,13,19,26,27,101
867070,2,9,11,14,19,25,29,109
867154,8,9,14,20,24,31,33,139
867260,6,8,9,19,25,29,33,129
867342,2,7,8,13,21,24,25,100
867478,1,6,16,20,21,24,27,115
867717,1,5,9,19,24,25,28,111
867886,6,9,16,17,23,24,28,123
867949,6,14,16,19,22,23,29,129
868118,7,12,17,20,24,27,33,140
868153,1,4,15,18,21,25,29,113
868185,1,7,9,11,17,26,32,103
868243,1,7,10,14,17,27,32,108
868312,3,7,9,11,21,28,30,109
868455,4,7,17,20,27,31,33,139
868475,1,3,7,11,22,30,31,105
868623,2,3,8,14,25,29,33,114
868992,6,14,17,20,21,26,31,135
869039,4,5,8,18,22,25,31,113
869048,1,3,10,20,26,27,30,117
869082,2,6,9,18,26,29,35,125
869226,1,9,10,18,23,27,29,117
869355,5,9,11,14,22,25,33,119
869619,2,7,11,16,26,27,33,122
869623,6,9,14,16,22,29,33,129
869694,2,6,17,18,21,24,33,121
869747,4,5,8,20,23,26,29,115
869894,6,14,17,18,19,23,33,130
870011,2,5,9,20,21,29,35,121
870025,4,7,11,17,22,29,33,123
870447,3,7,8,14,22,27,33,114
870518,5,9,11,18,26,30,31,130
870522,8,9,14,18,24,27,29,129
870555,5,9,10,16,23,26,29,118
870560,3,5,17,18,24,29,33,129
870987,7,14,15,20,24,28,29,137
871323,3,4,7,13,17,27,30,101
871630,8,9,14,19,29,31,35,145
871648,5,7,8,11,21,27,34,113
872260,5,6,9,11,26,30,35,122
872573,8,9,18,20,25,29,31,140
872664,7,8,10,12,22,29,35,123
872740,4,8,17,18,21,25,27,120
872798,9,10,15,18,19,29,31,131
872897,6,8,9,20,24,29,35,131
873085,1,4,10,18,27,31,35,126
873117,8,14,17,20,24,29,33,145
873768,1,3,7,20,22,32,33,118
873791,2,7,14,20,22,27,31,123
873870,9,10,11,14,29,32,35,140
874112,7,9,17,20,23,24,25,125
874277,3,7,9,12,17,31,34,113
874648,4,8,15,19,29,31,35,141
874938,5,7,11,16,21,27,28,115
875015,2,6,10,16,21,25,29,109
875192,5,9,18,19,24,31,34,140
875453,6,7,8,17,21,24,27,110
875533,2,14,16,19,23,29,34,137
875589,2,7,11,18,19,25,30,112
875731,1,4,10,16,27,31,32,121
875867,7,9,11,14,17,28,33,119
875975,1,12,15,18,19,26,29,120
876083,4,7,8,18,21,24,25,107
876092,1,8,9,13,17,28,34,110
876451,3,4,8,17,27,29,35,123
876650,1,8,9,19,22,25,29,113
876880,2,6,7,11,17,30,34,107
876955,3,8,9,16,24,28,31,119
877549,5,9,15,16,17,27,30,119
877713,7,14,18,20,21,25,34,139
877785,1,7,16,20,26,29,30,129
877974,5,9,11,16,26,29,30,126
878163,5,8,11,18,22,31,35,130
878356,6,7,10,18,26,29,35,131
878646,3,9,14,18,19,24,29,116
878702,4,8,15,20,21,28,29,125
878781,1,12,16,18,22,29,33,131
879003,7,8,16,19,22,26,31,129
879189,6,7,17,18,23,31,35,137
879305,5,14,16,20,25,27,28,135
879360,1,9,16,24,26,29,30,135
879624,4,5,8,19,23,25,27,111
879729,5,10,11,14,22,31,35,128
879836,1,4,14,20,23,24,27,113
879862,1,5,7,11,22,29,30,105
879923,4,14,18,19,25,29,33,142
879993,6,12,16,17,21,26,27,125
880019,4,5,17,20,26,27,30,129
880112,2,4,18,19,25,29,35,132
880174,1,3,17,18,22,23,33,117
880202,2,8,17,20,21,31,33,132
880203,5,9,18,20,21,25,27,125
880444,1,5,16,19,22,23,34,120
880533,6,7,14,18,27,29,33,134
880637,1,9,18,20,23,29,33,133
880764,7,8,18,19,23,27,29,131
881069,9,12,15,16,21,29,35,137
881301,7,9,11,17,25,28,30,127
881367,4,7,11,17,22,24,30,115
881687,1,7,14,18,19,29,33,121
881735,1,7,14,18,21,29,35,125
881754,1,3,7,19,22,28,34,114
881898,3,6,18,20,26,27,31,131
881950,2,7,8,12,24,29,33,115
882027,1,9,17,18,21,27,32,125
882346,9,14,17,20,24,30,31,145
882727,2,4,11,19,24,25,29,114
882886,7,12,17,18,22,31,32,139
882924,1,3,9,16,22,26,31,108
883007,3,10,11,20,21,25,27,117
883169,2,10,17,18,23,29,33,132
883268,4,9,17,20,23,24,34,131
883399,3,9,14,16,19,24,28,113
883572,2,9,15,17,19,24,25,111
883631,3,7,18,19,22,28,35,132
883720,9,10,16,19,22,25,29,130
883892,3,9,15,18,19,24,32,120
884090,1,6,9,20,25,27,31,119
884202,5,6,9,19,21,24,25,109
884264,4,9,18,19,22,27,28,127
884347,7,12,14,20,24,25,29,131
884392,1,7,16,20,21,29,31,125
884393,8,9,11,13,17,24,29,111
884422,9,10,14,16,21,25,29,124
884999,3,8,9,20,24,30,31,125
885014,3,7,8,11,27,28,33,117
885275,7,14,17,19,22,23,27,129
885604,2,14,16,17,23,27,29,128
886112,7,12,14,18,19,28,29,127
886143,10,12,17,20,23,24,33,139
886249,5,14,18,24,25,26,35,147
886254,2,7,11,16,17,29,32,114
886268,5,6,8,11,23,27,35,115
887358,7,8,11,20,26,27,32,131
887423,2,9,15,18,19,29,30,122
887548,1,10,17,18,23,29,33,131
887551,4,9,17,24,25,31,35,145
887936,7,8,16,18,19,23,29,120
887948,6,7,8,20,25,31,35,132
888055,3,6,7,19,22,25,29,111
888535,6,7,15,18,21,25,29,121
888693,1,5,11,20,22,27,30,116
888736,4,8,9,24,26,29,35,135
888761,4,7,11,17,27,30,31,127
888860,2,10,16,20,21,29,33,131
889116,4,7,9,11,17,24,34,106
889139,9,14,17,18,23,24,27,132
889310,1,10,16,20,22,23,29,121
889373,4,9,14,18,23,28,29,125
890187,3,4,9,13,21,24,32,106
890348,7,10,11,16,19,26,27,116
890395,4,14,17,20,21,28,31,135
890626,4,5,14,20,25,26,29,123
890736,1,14,16,20,22,23,31,127
890925,8,14,17,18,19,31,33,140
891092,8,9,16,19,25,26,29,132
891094,4,8,9,13,23,26,29,112
